Club,Season,Expenditure,Arrivals,Income,Departures,Balance,League
Manchester United,02/03,48530000,15,3500000,15,-45030000,PremierLeague
Manchester City,02/03,44450000,16,750000,14,-43700000,PremierLeague
Newcastle United,02/03,34550000,13,225000,14,-34325000,PremierLeague
Middlesbrough FC,02/03,34080000,24,0,27,-34080000,PremierLeague
Liverpool FC,02/03,31500000,18,11800000,16,-19700000,PremierLeague
Sunderland AFC,02/03,29680000,26,0,19,-29680000,PremierLeague
West Bromwich Albion,02/03,16950000,10,0,7,-16950000,PremierLeague
Birmingham City,02/03,15680000,21,1150000,19,-14530000,PremierLeague
Everton FC,02/03,13730000,22,375000,17,-13355000,PremierLeague
Arsenal FC,02/03,12830000,19,8220000,19,-4610000,PremierLeague
Southampton FC,02/03,12000000,16,0,19,-12000000,PremierLeague
Tottenham Hotspur,02/03,10500000,23,1350000,23,-9150000,PremierLeague
Aston Villa,02/03,9080000,24,6900000,17,-2180000,PremierLeague
Blackburn Rovers,02/03,7250000,21,1800000,18,-5450000,PremierLeague
Charlton Athletic,02/03,6750000,13,2650000,13,-4100000,PremierLeague
Leeds United,02/03,4500000,20,80120000,21,75620000,PremierLeague
Fulham FC,02/03,3000000,9,825000,12,-2175000,PremierLeague
West Ham United,02/03,400000,18,75000,19,-325000,PremierLeague
Bolton Wanderers,02/03,0,24,5290000,31,5290000,PremierLeague
Chelsea FC,02/03,0,10,2100000,11,2100000,PremierLeague
Chelsea FC,03/04,170000000,28,950000,22,-169050000,PremierLeague
Manchester United,03/04,56530000,27,59300000,28,2770000,PremierLeague
Tottenham Hotspur,03/04,29750000,20,1750000,23,-28000000,PremierLeague
Arsenal FC,03/04,27420000,24,1050000,22,-26370000,PremierLeague
Blackburn Rovers,03/04,22340000,25,34850000,32,12510000,PremierLeague
Birmingham City,03/04,17100000,17,1950000,27,-15150000,PremierLeague
Liverpool FC,03/04,15650000,22,0,13,-15650000,PremierLeague
Manchester City,03/04,14260000,23,6620000,24,-7640000,PremierLeague
Portsmouth FC,03/04,11780000,38,200000,39,-11580000,PremierLeague
Middlesbrough FC,03/04,10200000,30,1130000,31,-9070000,PremierLeague
Everton FC,03/04,10070000,18,975000,20,-9095000,PremierLeague
Wolverhampton Wanderers,03/04,9880000,27,1150000,20,-8730000,PremierLeague
Southampton FC,03/04,8980000,21,10880000,20,1900000,PremierLeague
Fulham FC,03/04,8480000,33,25040000,28,16560000,PremierLeague
Aston Villa,03/04,8380000,20,290000,29,-8090000,PremierLeague
Charlton Athletic,03/04,1500000,19,15000000,17,13500000,PremierLeague
Leicester City,03/04,1140000,29,0,29,-1140000,PremierLeague
Bolton Wanderers,03/04,750000,29,75000,30,-675000,PremierLeague
Leeds United,03/04,100000,28,16830000,32,16730000,PremierLeague
Newcastle United,03/04,0,17,5000000,22,5000000,PremierLeague
Chelsea FC,04/05,162400000,24,3300000,25,-159100000,PremierLeague
Manchester United,04/05,61250000,21,9570000,19,-51680000,PremierLeague
Liverpool FC,04/05,58400000,25,24570000,23,-33830000,PremierLeague
Tottenham Hotspur,04/05,47130000,38,10500000,34,-36630000,PremierLeague
Newcastle United,04/05,29450000,18,22280000,19,-7170000,PremierLeague
West Bromwich Albion,04/05,15850000,18,1950000,24,-13900000,PremierLeague
Birmingham City,04/05,15770000,28,8150000,23,-7620000,PremierLeague
Fulham FC,04/05,13950000,26,5200000,22,-8750000,PremierLeague
Charlton Athletic,04/05,13250000,17,1950000,19,-11300000,PremierLeague
Southampton FC,04/05,12680000,37,11500000,29,-1180000,PremierLeague
Arsenal FC,04/05,12480000,24,3900000,19,-8580000,PremierLeague
Everton FC,04/05,11880000,9,45400000,17,33520000,PremierLeague
Portsmouth FC,04/05,10850000,29,6600000,36,-4250000,PremierLeague
Aston Villa,04/05,10140000,14,3430000,18,-6710000,PremierLeague
Norwich City,04/05,8530000,18,450000,15,-8080000,PremierLeague
Blackburn Rovers,04/05,7880000,21,7700000,21,-180000,PremierLeague
Middlesbrough FC,04/05,6750000,21,3450000,22,-3300000,PremierLeague
Crystal Palace,04/05,5150000,18,100000,16,-5050000,PremierLeague
Manchester City,04/05,1500000,18,7940000,19,6440000,PremierLeague
Bolton Wanderers,04/05,1380000,26,375000,26,-1005000,PremierLeague
Chelsea FC,05/06,91500000,19,34600000,19,-56900000,PremierLeague
Newcastle United,05/06,61750000,17,30900000,16,-30850000,PremierLeague
Arsenal FC,05/06,46000000,20,25000000,18,-21000000,PremierLeague
Liverpool FC,05/06,44060000,30,19040000,26,-25020000,PremierLeague
Tottenham Hotspur,05/06,36510000,28,25450000,27,-11060000,PremierLeague
Everton FC,05/06,32530000,16,7000000,14,-25530000,PremierLeague
Manchester United,05/06,31800000,25,7900000,27,-23900000,PremierLeague
West Ham United,05/06,21590000,33,550000,31,-21040000,PremierLeague
Portsmouth FC,05/06,18780000,40,12150000,37,-6630000,PremierLeague
Aston Villa,05/06,16540000,18,6400000,15,-10140000,PremierLeague
Wigan Athletic,05/06,15770000,17,5630000,19,-10140000,PremierLeague
West Bromwich Albion,05/06,15300000,16,9080000,18,-6220000,PremierLeague
Middlesbrough FC,05/06,13960000,20,0,12,-13960000,PremierLeague
Manchester City,05/06,12480000,13,32500000,13,20020000,PremierLeague
Blackburn Rovers,05/06,9400000,23,2700000,25,-6700000,PremierLeague
Charlton Athletic,05/06,9100000,31,5710000,23,-3390000,PremierLeague
Birmingham City,05/06,8100000,32,7950000,27,-150000,PremierLeague
Fulham FC,05/06,6550000,25,4630000,24,-1920000,PremierLeague
Bolton Wanderers,05/06,6200000,14,0,17,-6200000,PremierLeague
Sunderland AFC,05/06,5930000,24,1430000,27,-4500000,PremierLeague
Chelsea FC,06/07,88980000,20,52600000,17,-36380000,PremierLeague
West Ham United,06/07,69850000,22,6750000,23,-63100000,PremierLeague
Tottenham Hotspur,06/07,61000000,22,38650000,22,-22350000,PremierLeague
Liverpool FC,06/07,46000000,30,24730000,28,-21270000,PremierLeague
Newcastle United,06/07,31880000,11,11180000,14,-20700000,PremierLeague
Wigan Athletic,06/07,29380000,23,24330000,25,-5050000,PremierLeague
Manchester United,06/07,27200000,27,18000000,27,-9200000,PremierLeague
Aston Villa,06/07,24700000,18,1830000,16,-22870000,PremierLeague
Charlton Athletic,06/07,21650000,33,2280000,36,-19370000,PremierLeague
Sheffield United,06/07,18030000,42,3330000,38,-14700000,PremierLeague
Blackburn Rovers,06/07,17980000,27,16910000,24,-1070000,PremierLeague
Everton FC,06/07,17900000,14,2500000,17,-15400000,PremierLeague
Bolton Wanderers,06/07,17000000,21,3850000,16,-13150000,PremierLeague
Arsenal FC,06/07,15000000,17,12930000,19,-2070000,PremierLeague
Fulham FC,06/07,13800000,20,10520000,25,-3280000,PremierLeague
Middlesbrough FC,06/07,11300000,21,4680000,24,-6620000,PremierLeague
Watford FC,06/07,10480000,32,13500000,23,3020000,PremierLeague
Reading FC,06/07,9230000,27,0,17,-9230000,PremierLeague
Portsmouth FC,06/07,9100000,29,1250000,32,-7850000,PremierLeague
Manchester City,06/07,6500000,20,4200000,23,-2300000,PremierLeague
Manchester United,07/08,106500000,26,46600000,22,-59900000,PremierLeague
Tottenham Hotspur,07/08,94150000,27,22550000,21,-71600000,PremierLeague
Liverpool FC,07/08,90700000,30,46750000,28,-43950000,PremierLeague
Manchester City,07/08,77950000,33,10560000,26,-67390000,PremierLeague
Sunderland AFC,07/08,64320000,31,3200000,21,-61120000,PremierLeague
Chelsea FC,07/08,59000000,24,43650000,16,-15350000,PremierLeague
Portsmouth FC,07/08,58640000,28,23380000,25,-35260000,PremierLeague
Middlesbrough FC,07/08,50600000,21,30230000,23,-20370000,PremierLeague
Fulham FC,07/08,50430000,39,19500000,27,-30930000,PremierLeague
West Ham United,07/08,47150000,19,42000000,17,-5150000,PremierLeague
Newcastle United,07/08,37850000,20,31700000,17,-6150000,PremierLeague
Everton FC,07/08,37550000,17,14800000,18,-22750000,PremierLeague
Arsenal FC,07/08,30950000,19,56730000,18,25780000,PremierLeague
Birmingham City,07/08,29300000,31,8480000,30,-20820000,PremierLeague
Aston Villa,07/08,24900000,12,17900000,17,-7000000,PremierLeague
Derby County,07/08,22680000,30,5240000,29,-17440000,PremierLeague
Bolton Wanderers,07/08,22350000,25,21970000,24,-380000,PremierLeague
Wigan Athletic,07/08,17900000,26,17830000,21,-70000,PremierLeague
Reading FC,07/08,12100000,40,5700000,35,-6400000,PremierLeague
Blackburn Rovers,07/08,6200000,19,3980000,18,-2220000,PremierLeague
Manchester City,08/09,157350000,26,26500000,18,-130850000,PremierLeague
Tottenham Hotspur,08/09,143950000,38,88050000,36,-55900000,PremierLeague
Liverpool FC,08/09,71450000,33,46450000,29,-25000000,PremierLeague
Aston Villa,08/09,55900000,19,7520000,15,-48380000,PremierLeague
Manchester United,08/09,45250000,17,7450000,17,-37800000,PremierLeague
Arsenal FC,08/09,40150000,18,25800000,11,-14350000,PremierLeague
Newcastle United,08/09,35480000,23,41400000,16,5920000,PremierLeague
Stoke City,08/09,33950000,24,765000,19,-33185000,PremierLeague
Sunderland AFC,08/09,33110000,34,11150000,35,-21960000,PremierLeague
Chelsea FC,08/09,30500000,18,44550000,18,14050000,PremierLeague
Portsmouth FC,08/09,28200000,30,54150000,26,25950000,PremierLeague
Fulham FC,08/09,26850000,31,16330000,41,-10520000,PremierLeague
Everton FC,08/09,25080000,15,13300000,11,-11780000,PremierLeague
West Bromwich Albion,08/09,24320000,22,10250000,24,-14070000,PremierLeague
Wigan Athletic,08/09,24100000,24,24500000,28,400000,PremierLeague
Bolton Wanderers,08/09,23700000,15,10880000,19,-12820000,PremierLeague
Hull City,08/09,17950000,26,0,18,-17950000,PremierLeague
West Ham United,08/09,16000000,28,68830000,30,52830000,PremierLeague
Middlesbrough FC,08/09,12800000,18,8720000,19,-4080000,PremierLeague
Blackburn Rovers,08/09,11680000,26,26500000,28,14820000,PremierLeague
Manchester City,09/10,147300000,29,29200000,29,-118100000,PremierLeague
Aston Villa,09/10,46900000,21,22100000,16,-24800000,PremierLeague
Sunderland AFC,09/10,46100000,27,21280000,29,-24820000,PremierLeague
Liverpool FC,09/10,43500000,25,48550000,26,5050000,PremierLeague
Tottenham Hotspur,09/10,40300000,35,31700000,32,-8600000,PremierLeague
Chelsea FC,09/10,30000000,18,3800000,12,-26200000,PremierLeague
Manchester United,09/10,27300000,18,104470000,17,77170000,PremierLeague
Stoke City,09/10,26050000,25,6500000,23,-19550000,PremierLeague
Everton FC,09/10,23300000,15,28340000,15,5040000,PremierLeague
West Ham United,09/10,21650000,23,41300000,26,19650000,PremierLeague
Birmingham City,09/10,20050000,28,400000,28,-19650000,PremierLeague
Wolverhampton Wanderers,09/10,19450000,32,870000,28,-18580000,PremierLeague
Wigan Athletic,09/10,18440000,21,25980000,20,7540000,PremierLeague
Hull City,09/10,14850000,24,16200000,27,1350000,PremierLeague
Burnley FC,09/10,13540000,33,90000,20,-13450000,PremierLeague
Blackburn Rovers,09/10,13280000,39,36650000,35,23370000,PremierLeague
Arsenal FC,09/10,12000000,17,47700000,13,35700000,PremierLeague
Bolton Wanderers,09/10,12000000,25,2000000,17,-10000000,PremierLeague
Portsmouth FC,09/10,10560000,35,52050000,40,41490000,PremierLeague
Fulham FC,09/10,7110000,28,0,26,-7110000,PremierLeague
Manchester City,10/11,183610000,36,40150000,26,-143460000,PremierLeague
Chelsea FC,10/11,121500000,22,16500000,21,-105000000,PremierLeague
Liverpool FC,10/11,97730000,25,101500000,24,3770000,PremierLeague
Aston Villa,10/11,37400000,21,28400000,21,-9000000,PremierLeague
Manchester United,10/11,29300000,18,16970000,18,-12330000,PremierLeague
Sunderland AFC,10/11,29100000,31,41780000,32,12680000,PremierLeague
Tottenham Hotspur,10/11,26600000,43,2940000,34,-23660000,PremierLeague
Birmingham City,10/11,25600000,25,175000,23,-25425000,PremierLeague
Arsenal FC,10/11,23000000,23,8100000,22,-14900000,PremierLeague
Stoke City,10/11,21100000,26,6780000,23,-14320000,PremierLeague
Wolverhampton Wanderers,10/11,20220000,29,6440000,27,-13780000,PremierLeague
West Ham United,10/11,18030000,18,4950000,20,-13080000,PremierLeague
Newcastle United,10/11,13980000,18,41750000,16,27770000,PremierLeague
West Bromwich Albion,10/11,13830000,30,850000,26,-12980000,PremierLeague
Wigan Athletic,10/11,11400000,25,3400000,21,-8000000,PremierLeague
Fulham FC,10/11,11050000,16,12810000,23,1760000,PremierLeague
Blackpool FC,10/11,5730000,28,700000,24,-5030000,PremierLeague
Bolton Wanderers,10/11,5400000,18,1400000,20,-4000000,PremierLeague
Blackburn Rovers,10/11,5050000,30,275000,30,-4775000,PremierLeague
Everton FC,10/11,1700000,14,6600000,14,4900000,PremierLeague
Chelsea FC,11/12,96450000,26,31560000,22,-64890000,PremierLeague
Manchester City,11/12,91050000,34,31200000,36,-59850000,PremierLeague
Arsenal FC,11/12,65480000,37,78290000,26,12810000,PremierLeague
Liverpool FC,11/12,65330000,24,22000000,18,-43330000,PremierLeague
Manchester United,11/12,62300000,17,12900000,18,-49400000,PremierLeague
Sunderland AFC,11/12,27920000,37,26330000,32,-1590000,PremierLeague
Newcastle United,11/12,27000000,29,16040000,26,-10960000,PremierLeague
Queens Park Rangers,11/12,26230000,46,2800000,43,-23430000,PremierLeague
Stoke City,11/12,24800000,26,1990000,26,-22810000,PremierLeague
Blackburn Rovers,11/12,20550000,26,40300000,28,19750000,PremierLeague
Aston Villa,11/12,20340000,21,43750000,25,23410000,PremierLeague
Fulham FC,11/12,18130000,22,7670000,17,-10460000,PremierLeague
Bolton Wanderers,11/12,15600000,24,16330000,22,730000,PremierLeague
Norwich City,11/12,15250000,19,500000,18,-14750000,PremierLeague
Swansea City,11/12,12850000,23,455000,22,-12395000,PremierLeague
Wigan Athletic,11/12,12380000,24,11290000,15,-1090000,PremierLeague
Wolverhampton Wanderers,11/12,12050000,30,2600000,32,-9450000,PremierLeague
West Bromwich Albion,11/12,9140000,26,11120000,26,1980000,PremierLeague
Tottenham Hotspur,11/12,9000000,40,43250000,36,34250000,PremierLeague
Everton FC,11/12,7200000,20,26800000,17,19600000,PremierLeague
Chelsea FC,12/13,109700000,38,25450000,28,-84250000,PremierLeague
Manchester United,12/13,76450000,20,9650000,15,-66800000,PremierLeague
Tottenham Hotspur,12/13,73250000,35,72780000,34,-470000,PremierLeague
Liverpool FC,12/13,70600000,20,10450000,18,-60150000,PremierLeague
Manchester City,12/13,61950000,26,44300000,26,-17650000,PremierLeague
Arsenal FC,12/13,56000000,25,65850000,19,9850000,PremierLeague
Queens Park Rangers,12/13,50350000,45,4510000,46,-45840000,PremierLeague
Southampton FC,12/13,41500000,31,0,25,-41500000,PremierLeague
Sunderland AFC,12/13,38300000,27,14830000,31,-23470000,PremierLeague
Newcastle United,12/13,31970000,21,14800000,19,-17170000,PremierLeague
Aston Villa,12/13,27830000,20,3200000,13,-24630000,PremierLeague
West Ham United,12/13,23900000,26,5050000,29,-18850000,PremierLeague
Stoke City,12/13,23680000,24,640000,24,-23040000,PremierLeague
Everton FC,12/13,21650000,13,18750000,13,-2900000,PremierLeague
Swansea City,12/13,20470000,20,32600000,23,12130000,PremierLeague
Norwich City,12/13,11080000,29,380000,26,-10700000,PremierLeague
Reading FC,12/13,10820000,33,900000,27,-9920000,PremierLeague
Wigan Athletic,12/13,10540000,22,13250000,25,2710000,PremierLeague
Fulham FC,12/13,10000000,28,31420000,32,21420000,PremierLeague
West Bromwich Albion,12/13,5000000,17,3730000,18,-1270000,PremierLeague
Chelsea FC,13/14,130350000,52,77930000,36,-52420000,PremierLeague
Tottenham Hotspur,13/14,122550000,33,138400000,28,15850000,PremierLeague
Manchester City,13/14,115500000,16,11300000,18,-104200000,PremierLeague
Manchester United,13/14,77130000,23,1800000,20,-75330000,PremierLeague
Liverpool FC,13/14,58100000,23,32500000,24,-25600000,PremierLeague
Arsenal FC,13/14,49250000,25,12150000,25,-37100000,PremierLeague
Cardiff City,13/14,45820000,35,3740000,29,-42080000,PremierLeague
Southampton FC,13/14,39600000,18,4200000,23,-35400000,PremierLeague
Sunderland AFC,13/14,33910000,40,22380000,35,-11530000,PremierLeague
Crystal Palace,13/14,33000000,44,0,32,-33000000,PremierLeague
Everton FC,13/14,31800000,19,46100000,21,14300000,PremierLeague
Hull City,13/14,31100000,32,880000,32,-30220000,PremierLeague
Norwich City,13/14,30050000,21,4840000,24,-25210000,PremierLeague
Fulham FC,13/14,29300000,34,4150000,30,-25150000,PremierLeague
Swansea City,13/14,26610000,24,0,21,-26610000,PremierLeague
West Ham United,13/14,24000000,25,530000,22,-23470000,PremierLeague
Aston Villa,13/14,19840000,33,8100000,29,-11740000,PremierLeague
West Bromwich Albion,13/14,15700000,17,11400000,20,-4300000,PremierLeague
Stoke City,13/14,7000000,21,0,20,-7000000,PremierLeague
Newcastle United,13/14,3800000,17,25870000,18,22070000,PremierLeague
Manchester United,14/15,195350000,30,46700000,28,-148650000,PremierLeague
Liverpool FC,14/15,151430000,30,99270000,21,-52160000,PremierLeague
Chelsea FC,14/15,137700000,57,142810000,48,5110000,PremierLeague
Arsenal FC,14/15,118980000,21,27800000,22,-91180000,PremierLeague
Manchester City,14/15,102800000,22,30300000,17,-72500000,PremierLeague
Southampton FC,14/15,96000000,26,123830000,24,27830000,PremierLeague
Tottenham Hotspur,14/15,48480000,23,44150000,24,-4330000,PremierLeague
Hull City,14/15,48220000,31,18700000,28,-29520000,PremierLeague
Newcastle United,14/15,45020000,28,23870000,26,-21150000,PremierLeague
Queens Park Rangers,14/15,43540000,35,26040000,38,-17500000,PremierLeague
Swansea City,14/15,41530000,25,61900000,28,20370000,PremierLeague
Everton FC,14/15,40160000,17,1900000,16,-38260000,PremierLeague
West Ham United,14/15,35150000,26,4400000,27,-30750000,PremierLeague
Crystal Palace,14/15,31220000,41,2870000,39,-28350000,PremierLeague
West Bromwich Albion,14/15,24880000,18,2300000,20,-22580000,PremierLeague
Leicester City,14/15,22860000,30,0,23,-22860000,PremierLeague
Sunderland AFC,14/15,22520000,24,7250000,33,-15270000,PremierLeague
Aston Villa,14/15,13450000,33,1320000,33,-12130000,PremierLeague
Burnley FC,14/15,12620000,24,0,23,-12620000,PremierLeague
Stoke City,14/15,1800000,18,3800000,20,2000000,PremierLeague
Manchester City,15/16,208470000,29,67440000,25,-141030000,PremierLeague
Manchester United,15/16,156000000,22,100670000,20,-55330000,PremierLeague
Liverpool FC,15/16,126500000,30,90550000,24,-35950000,PremierLeague
Newcastle United,15/16,107910000,28,5630000,24,-102280000,PremierLeague
Chelsea FC,15/16,96500000,54,87490000,39,-9010000,PremierLeague
Watford FC,15/16,82800000,39,9750000,31,-73050000,PremierLeague
Tottenham Hotspur,15/16,71000000,12,87250000,21,16250000,PremierLeague
Aston Villa,15/16,66550000,31,64700000,32,-1850000,PremierLeague
Sunderland AFC,15/16,66050000,34,11000000,28,-55050000,PremierLeague
Southampton FC,15/16,60100000,16,52700000,17,-7400000,PremierLeague
AFC Bournemouth,15/16,55110000,37,650000,35,-54460000,PremierLeague
Stoke City,15/16,53650000,14,23200000,14,-30450000,PremierLeague
West Ham United,15/16,52700000,27,18520000,29,-34180000,PremierLeague
Norwich City,15/16,50500000,35,21490000,31,-29010000,PremierLeague
Leicester City,15/16,49900000,27,9450000,32,-40450000,PremierLeague
Everton FC,15/16,48200000,19,11000000,17,-37200000,PremierLeague
West Bromwich Albion,15/16,42900000,12,12920000,13,-29980000,PremierLeague
Crystal Palace,15/16,28800000,19,5400000,23,-23400000,PremierLeague
Arsenal FC,15/16,26500000,16,2500000,12,-24000000,PremierLeague
Swansea City,15/16,21810000,23,16810000,24,-5000000,PremierLeague
Manchester City,16/17,216250000,42,35350000,25,-180900000,PremierLeague
Manchester United,16/17,185000000,11,47250000,14,-137750000,PremierLeague
Chelsea FC,16/17,132800000,41,108900000,30,-23900000,PremierLeague
Arsenal FC,16/17,113000000,13,10350000,12,-102650000,PremierLeague
Crystal Palace,16/17,101200000,23,50200000,24,-51000000,PremierLeague
Leicester City,16/17,92100000,17,66050000,19,-26050000,PremierLeague
Everton FC,16/17,86000000,21,60800000,19,-25200000,PremierLeague
Tottenham Hotspur,16/17,83500000,11,52300000,9,-31200000,PremierLeague
West Ham United,16/17,83500000,22,41000000,17,-42500000,PremierLeague
Liverpool FC,16/17,79900000,23,85380000,19,5480000,PremierLeague
Watford FC,16/17,70450000,38,58100000,35,-12350000,PremierLeague
Southampton FC,16/17,68900000,13,85050000,10,16150000,PremierLeague
Swansea City,16/17,58100000,23,49300000,17,-8800000,PremierLeague
Middlesbrough FC,16/17,47950000,21,13500000,20,-34450000,PremierLeague
Burnley FC,16/17,45600000,28,1200000,26,-44400000,PremierLeague
Stoke City,16/17,42170000,17,3800000,14,-38370000,PremierLeague
Sunderland AFC,16/17,41900000,27,23770000,24,-18130000,PremierLeague
AFC Bournemouth,16/17,40690000,20,23690000,30,-17000000,PremierLeague
Hull City,16/17,40000000,25,28900000,20,-11100000,PremierLeague
West Bromwich Albion,16/17,37900000,14,26980000,14,-10920000,PremierLeague
Manchester City,17/18,317500000,38,91350000,32,-226150000,PremierLeague
Chelsea FC,17/18,260500000,47,194600000,31,-65900000,PremierLeague
Everton FC,17/18,203200000,27,126380000,20,-76820000,PremierLeague
Manchester United,17/18,198400000,14,45500000,11,-152900000,PremierLeague
Liverpool FC,17/18,173650000,16,184500000,15,10850000,PremierLeague
Arsenal FC,17/18,152850000,15,162000000,16,9150000,PremierLeague
Tottenham Hotspur,17/18,121000000,15,103800000,11,-17200000,PremierLeague
Leicester City,17/18,83850000,17,50100000,14,-33750000,PremierLeague
Watford FC,17/18,73400000,43,18740000,34,-54660000,PremierLeague
Swansea City,17/18,73390000,25,81100000,25,7710000,PremierLeague
Brighton & Hove Albion,17/18,66500000,26,400000,22,-66100000,PremierLeague
Southampton FC,17/18,61250000,14,98350000,14,37100000,PremierLeague
Stoke City,17/18,57700000,21,35140000,19,-22560000,PremierLeague
West Ham United,17/18,56800000,16,69020000,26,12220000,PremierLeague
Huddersfield Town,17/18,56750000,22,6460000,19,-50290000,PremierLeague
West Bromwich Albion,17/18,53500000,18,2050000,13,-51450000,PremierLeague
Crystal Palace,17/18,48950000,15,3000000,19,-45950000,PremierLeague
Newcastle United,17/18,46500000,31,21220000,31,-25280000,PremierLeague
Burnley FC,17/18,35740000,18,50000000,21,14260000,PremierLeague
AFC Bournemouth,17/18,34300000,17,0,14,-34300000,PremierLeague
Chelsea FC,18/19,208800000,41,83250000,33,-125550000,PremierLeague
Liverpool FC,18/19,182200000,22,41320000,20,-140880000,PremierLeague
Fulham FC,18/19,116500000,20,5350000,15,-111150000,PremierLeague
Leicester City,18/19,114600000,20,95800000,19,-18800000,PremierLeague
Wolverhampton Wanderers,18/19,112750000,42,23300000,48,-89450000,PremierLeague
West Ham United,18/19,100900000,20,13770000,13,-87130000,PremierLeague
Everton FC,18/19,99800000,27,28650000,24,-71150000,PremierLeague
AFC Bournemouth,18/19,91600000,14,20200000,16,-71400000,PremierLeague
Brighton & Hove Albion,18/19,87120000,36,13620000,29,-73500000,PremierLeague
Manchester United,18/19,82700000,10,30550000,10,-52150000,PremierLeague
Arsenal FC,18/19,80150000,19,9100000,13,-71050000,PremierLeague
Manchester City,18/19,78590000,28,57600000,22,-20990000,PremierLeague
Southampton FC,18/19,62250000,21,26100000,19,-36150000,PremierLeague
Newcastle United,18/19,59750000,23,51050000,24,-8700000,PremierLeague
Huddersfield Town,18/19,50700000,16,12330000,18,-38370000,PremierLeague
Cardiff City,18/19,40200000,18,0,20,-40200000,PremierLeague
Burnley FC,18/19,33000000,10,8000000,11,-25000000,PremierLeague
Watford FC,18/19,30100000,37,51840000,27,21740000,PremierLeague
Crystal Palace,18/19,11850000,13,350000,18,-11500000,PremierLeague
Tottenham Hotspur,18/19,0,5,5350000,4,5350000,PremierLeague
Manchester United,19/20,234800000,16,81180000,12,-153620000,PremierLeague
Manchester City,19/20,166820000,36,71000000,25,-95820000,PremierLeague
Arsenal FC,19/20,160800000,20,53650000,21,-107150000,PremierLeague
Aston Villa,19/20,159500000,28,3000000,26,-156500000,PremierLeague
Tottenham Hotspur,19/20,150500000,16,64500000,15,-86000000,PremierLeague
Everton FC,19/20,121000000,27,87800000,23,-33200000,PremierLeague
West Ham United,19/20,119800000,15,55480000,18,-64320000,PremierLeague
Wolverhampton Wanderers,19/20,116700000,30,24100000,24,-92600000,PremierLeague
Leicester City,19/20,104300000,19,88500000,14,-15800000,PremierLeague
Newcastle United,19/20,72900000,16,35640000,15,-37260000,PremierLeague
Sheffield United,19/20,70500000,26,350000,22,-70150000,PremierLeague
Brighton & Hove Albion,19/20,61740000,36,8500000,30,-53240000,PremierLeague
Southampton FC,19/20,61500000,21,27300000,19,-34200000,PremierLeague
Watford FC,19/20,56000000,32,25400000,21,-30600000,PremierLeague
AFC Bournemouth,19/20,54910000,17,34630000,13,-20280000,PremierLeague
Chelsea FC,19/20,45000000,35,157270000,28,112270000,PremierLeague
Burnley FC,19/20,23850000,9,13550000,10,-10300000,PremierLeague
Liverpool FC,19/20,10400000,20,44500000,15,34100000,PremierLeague
Norwich City,19/20,8820000,28,2200000,29,-6620000,PremierLeague
Crystal Palace,19/20,7600000,15,55380000,15,47780000,PremierLeague
Chelsea FC,20/21,247200000,41,57150000,25,-190050000,PremierLeague
Manchester City,20/21,173400000,36,64000000,25,-109400000,PremierLeague
Leeds United,20/21,127800000,17,0,17,-127800000,PremierLeague
Tottenham Hotspur,20/21,110500000,18,13300000,13,-97200000,PremierLeague
Aston Villa,20/21,101350000,14,2770000,16,-98580000,PremierLeague
Wolverhampton Wanderers,20/21,87590000,26,79200000,25,-8390000,PremierLeague
Arsenal FC,20/21,86000000,20,19150000,19,-66850000,PremierLeague
Liverpool FC,20/21,84050000,20,17200000,14,-66850000,PremierLeague
Manchester United,20/21,83800000,18,19500000,15,-64300000,PremierLeague
Everton FC,20/21,73370000,23,4430000,21,-68940000,PremierLeague
Sheffield United,20/21,62700000,17,0,19,-62700000,PremierLeague
Leicester City,20/21,59400000,21,53770000,19,-5630000,PremierLeague
West Ham United,20/21,54700000,18,45410000,17,-9290000,PremierLeague
West Bromwich Albion,20/21,42140000,23,8100000,23,-34040000,PremierLeague
Newcastle United,20/21,39000000,13,275000,15,-38725000,PremierLeague
Southampton FC,20/21,37300000,24,26300000,19,-11000000,PremierLeague
Fulham FC,20/21,37250000,26,0,24,-37250000,PremierLeague
Brighton & Hove Albion,20/21,28500000,34,20600000,23,-7900000,PremierLeague
Crystal Palace,20/21,22400000,14,20000000,8,-2400000,PremierLeague
Burnley FC,20/21,1100000,6,2300000,6,1200000,PremierLeague
Arsenal FC,21/22,167400000,21,31400000,20,-136000000,PremierLeague
Manchester United,21/22,142000000,20,30700000,13,-111300000,PremierLeague
Manchester City,21/22,138900000,32,93800000,22,-45100000,PremierLeague
Newcastle United,21/22,130500000,13,0,11,-130500000,PremierLeague
Aston Villa,21/22,129800000,26,127000000,20,-2800000,PremierLeague
Chelsea FC,21/22,118000000,25,124600000,23,6600000,PremierLeague
Tottenham Hotspur,21/22,95900000,18,34620000,20,-61280000,PremierLeague
Liverpool FC,21/22,87000000,15,29550000,12,-57450000,PremierLeague
Crystal Palace,21/22,85620000,14,0,16,-85620000,PremierLeague
Brighton & Hove Albion,21/22,75000000,33,78500000,29,3500000,PremierLeague
West Ham United,21/22,74500000,10,4240000,10,-70260000,PremierLeague
Leicester City,21/22,67600000,12,4000000,12,-63600000,PremierLeague
Norwich City,21/22,63550000,34,38400000,33,-25150000,PremierLeague
Leeds United,21/22,59300000,16,0,14,-59300000,PremierLeague
Burnley FC,21/22,49400000,8,40500000,6,-8900000,PremierLeague
Watford FC,21/22,43500000,35,12850000,30,-30650000,PremierLeague
Southampton FC,21/22,43100000,11,60350000,14,17250000,PremierLeague
Everton FC,21/22,39500000,17,46000000,16,6500000,PremierLeague
Wolverhampton Wanderers,21/22,37600000,30,31800000,22,-5800000,PremierLeague
Brentford FC,21/22,36700000,21,1000000,17,-35700000,PremierLeague
Chelsea FC,22/23,611490000,31,67830000,25,-543660000,PremierLeague
Manchester United,22/23,243280000,26,13250000,21,-230030000,PremierLeague
West Ham United,22/23,194000000,15,21550000,13,-172450000,PremierLeague
Arsenal FC,22/23,192360000,29,23800000,16,-168560000,PremierLeague
Newcastle United,22/23,185350000,19,2300000,13,-183050000,PremierLeague
Nottingham Forest,22/23,184250000,48,5000000,28,-179250000,PremierLeague
Tottenham Hotspur,22/23,177900000,23,38750000,18,-139150000,PremierLeague
Wolverhampton Wanderers,22/23,177110000,36,60370000,27,-116740000,PremierLeague
Manchester City,22/23,150500000,28,162470000,21,11970000,PremierLeague
Leeds United,22/23,145590000,24,113500000,18,-32090000,PremierLeague
Southampton FC,22/23,143650000,22,5500000,14,-138150000,PremierLeague
Liverpool FC,22/23,137300000,9,80700000,12,-56600000,PremierLeague
Aston Villa,22/23,100140000,25,54000000,22,-46140000,PremierLeague
AFC Bournemouth,22/23,83100000,21,0,15,-83100000,PremierLeague
Everton FC,22/23,78200000,21,103600000,19,25400000,PremierLeague
Fulham FC,22/23,70500000,25,21900000,24,-48600000,PremierLeague
Brighton & Hove Albion,22/23,55730000,27,137900000,23,82170000,PremierLeague
Brentford FC,22/23,51500000,22,3600000,19,-47900000,PremierLeague
Leicester City,22/23,48000000,11,81400000,10,33400000,PremierLeague
Crystal Palace,22/23,46600000,13,5460000,11,-41140000,PremierLeague
Real Madrid,02/03,45000000,20,8200000,14,-36800000,LaLiga
Deportivo de La Coru?a,02/03,42660000,20,9700000,15,-32960000,LaLiga
Atl?tico de Madrid,02/03,31200000,22,8100000,22,-23100000,LaLiga
FC Barcelona,02/03,20000000,14,11550000,12,-8450000,LaLiga
Real Betis Balompi?,02/03,12200000,10,2900000,9,-9300000,LaLiga
Celta de Vigo,02/03,11500000,19,50000,16,-11450000,LaLiga
RCD Espanyol Barcelona,02/03,11270000,18,0,16,-11270000,LaLiga
Deportivo Alav?s,02/03,4400000,11,0,15,-4400000,LaLiga
Villarreal CF,02/03,2850000,15,60000,16,-2790000,LaLiga
Sevilla FC,02/03,2830000,11,0,12,-2830000,LaLiga
Real Sociedad,02/03,1600000,14,2400000,14,800000,LaLiga
Rayo Vallecano,02/03,750000,11,0,16,-750000,LaLiga
Racing Santander,02/03,500000,14,1800000,8,1300000,LaLiga
Recreativo Huelva,02/03,450000,18,70000,18,-380000,LaLiga
RCD Mallorca,02/03,200000,17,15000000,11,14800000,LaLiga
CA Osasuna,02/03,0,11,0,15,0,LaLiga
Real Valladolid CF,02/03,0,9,2230000,13,2230000,LaLiga
Athletic Bilbao,02/03,0,7,0,6,0,LaLiga
Valencia CF,02/03,0,14,1500000,12,1500000,LaLiga
M?laga CF,02/03,0,7,0,7,0,LaLiga
FC Barcelona,03/04,43850000,16,2900000,17,-40950000,LaLiga
Real Madrid,03/04,37500000,15,32800000,15,-4700000,LaLiga
Villarreal CF,03/04,12050000,15,4000000,15,-8050000,LaLiga
Atl?tico de Madrid,03/04,9800000,25,250000,25,-9550000,LaLiga
Real Betis Balompi?,03/04,8500000,16,0,10,-8500000,LaLiga
Valencia CF,03/04,8500000,17,4500000,10,-4000000,LaLiga
Sevilla FC,03/04,8200000,14,20000000,11,11800000,LaLiga
RCD Mallorca,03/04,6500000,19,11800000,19,5300000,LaLiga
Real Zaragoza,03/04,5800000,11,0,11,-5800000,LaLiga
Real Sociedad,03/04,4500000,13,0,11,-4500000,LaLiga
RCD Espanyol Barcelona,03/04,3200000,15,0,18,-3200000,LaLiga
Real Murcia CF,03/04,2700000,18,1500000,17,-1200000,LaLiga
CA Osasuna,03/04,2600000,11,0,9,-2600000,LaLiga
Deportivo de La Coru?a,03/04,2500000,19,19750000,13,17250000,LaLiga
Celta de Vigo,03/04,2500000,17,4000000,12,1500000,LaLiga
Albacete Balompi?,03/04,300000,16,0,19,-300000,LaLiga
Real Valladolid CF,03/04,0,15,0,15,0,LaLiga
Athletic Bilbao,03/04,0,2,0,7,0,LaLiga
Racing Santander,03/04,0,10,0,16,0,LaLiga
M?laga CF,03/04,0,10,7700000,13,7700000,LaLiga
FC Barcelona,04/05,78500000,20,14750000,16,-63750000,LaLiga
Real Madrid,04/05,58700000,13,9250000,11,-49450000,LaLiga
Valencia CF,04/05,40000000,28,8000000,19,-32000000,LaLiga
Atl?tico de Madrid,04/05,17600000,31,0,25,-17600000,LaLiga
Villarreal CF,04/05,15800000,11,8000000,9,-7800000,LaLiga
Sevilla FC,04/05,11530000,15,0,12,-11530000,LaLiga
Real Betis Balompi?,04/05,10950000,14,0,11,-10950000,LaLiga
Real Sociedad,04/05,6750000,20,16800000,15,10050000,LaLiga
Deportivo de La Coru?a,04/05,5000000,16,2200000,15,-2800000,LaLiga
Real Zaragoza,04/05,3850000,12,0,14,-3850000,LaLiga
Levante UD,04/05,3400000,12,0,14,-3400000,LaLiga
RCD Espanyol Barcelona,04/05,3050000,19,190000,21,-2860000,LaLiga
RCD Mallorca,04/05,2900000,20,27000000,29,24100000,LaLiga
Racing Santander,04/05,1140000,19,0,18,-1140000,LaLiga
M?laga CF,04/05,750000,7,3700000,10,2950000,LaLiga
CD Numancia,04/05,720000,20,630000,21,-90000,LaLiga
CA Osasuna,04/05,0,11,0,11,0,LaLiga
Athletic Bilbao,04/05,0,8,0,3,0,LaLiga
Albacete Balompi?,04/05,0,20,3730000,23,3730000,LaLiga
Getafe CF,04/05,0,15,0,16,0,LaLiga
Real Madrid,05/06,89500000,20,43100000,10,-46400000,LaLiga
Atl?tico de Madrid,05/06,26500000,24,5300000,19,-21200000,LaLiga
Valencia CF,05/06,24810000,33,13900000,20,-10910000,LaLiga
Sevilla FC,05/06,23000000,15,48200000,16,25200000,LaLiga
Villarreal CF,05/06,19900000,12,13350000,8,-6550000,LaLiga
RCD Espanyol Barcelona,05/06,15630000,19,6100000,19,-9530000,LaLiga
RCD Mallorca,05/06,9750000,23,5000000,28,-4750000,LaLiga
Real Zaragoza,05/06,7000000,13,14500000,15,7500000,LaLiga
Real Betis Balompi?,05/06,6550000,16,480000,15,-6070000,LaLiga
Racing Santander,05/06,5300000,22,6450000,22,1150000,LaLiga
Deportivo de La Coru?a,05/06,5000000,17,20180000,9,15180000,LaLiga
Celta de Vigo,05/06,4250000,16,0,19,-4250000,LaLiga
Real Sociedad,05/06,3500000,16,4800000,12,1300000,LaLiga
C?diz CF,05/06,3300000,12,0,7,-3300000,LaLiga
Athletic Bilbao,05/06,3000000,14,12000000,12,9000000,LaLiga
Getafe CF,05/06,1800000,13,600000,16,-1200000,LaLiga
M?laga CF,05/06,1520000,19,2000000,14,480000,LaLiga
Deportivo Alav?s,05/06,1400000,18,0,21,-1400000,LaLiga
CA Osasuna,05/06,1000000,8,5400000,10,4400000,LaLiga
FC Barcelona,05/06,0,13,11000000,9,11000000,LaLiga
Real Madrid,06/07,103000000,19,15350000,18,-87650000,LaLiga
Atl?tico de Madrid,06/07,58430000,27,7000000,21,-51430000,LaLiga
Valencia CF,06/07,49800000,24,20830000,18,-28970000,LaLiga
Villarreal CF,06/07,31040000,18,5450000,14,-25590000,LaLiga
FC Barcelona,06/07,31000000,9,13200000,8,-17800000,LaLiga
Real Betis Balompi?,06/07,24940000,16,40200000,14,15260000,LaLiga
Sevilla FC,06/07,18700000,18,1500000,13,-17200000,LaLiga
Real Zaragoza,06/07,16800000,15,17580000,16,780000,LaLiga
Athletic Bilbao,06/07,13900000,13,300000,10,-13600000,LaLiga
RCD Mallorca,06/07,13000000,17,3600000,20,-9400000,LaLiga
Deportivo de La Coru?a,06/07,11070000,28,6900000,26,-4170000,LaLiga
Racing Santander,06/07,9000000,18,400000,20,-8600000,LaLiga
Real Sociedad,06/07,8450000,16,6250000,17,-2200000,LaLiga
Celta de Vigo,06/07,4750000,12,0,18,-4750000,LaLiga
Getafe CF,06/07,4700000,13,12940000,15,8240000,LaLiga
Levante UD,06/07,3850000,18,0,16,-3850000,LaLiga
RCD Espanyol Barcelona,06/07,2830000,16,450000,13,-2380000,LaLiga
Gimn?stic de Tarragona,06/07,2150000,20,75000,31,-2075000,LaLiga
Recreativo Huelva,06/07,525000,19,0,26,-525000,LaLiga
CA Osasuna,06/07,400000,8,400000,7,0,LaLiga
Real Madrid,07/08,118000000,23,42400000,19,-75600000,LaLiga
Atl?tico de Madrid,07/08,80500000,23,52100000,17,-28400000,LaLiga
Valencia CF,07/08,72150000,34,7600000,22,-64550000,LaLiga
FC Barcelona,07/08,68500000,12,14000000,8,-54500000,LaLiga
Villarreal CF,07/08,40000000,30,44450000,27,4450000,LaLiga
Sevilla FC,07/08,29000000,22,21100000,17,-7900000,LaLiga
Real Betis Balompi?,07/08,24300000,19,1230000,15,-23070000,LaLiga
Real Zaragoza,07/08,21100000,20,25300000,15,4200000,LaLiga
Getafe CF,07/08,18000000,17,13000000,13,-5000000,LaLiga
Racing Santander,07/08,13530000,25,16900000,23,3370000,LaLiga
Athletic Bilbao,07/08,13300000,13,1000000,11,-12300000,LaLiga
CA Osasuna,07/08,10800000,21,23900000,17,13100000,LaLiga
UD Almer?a,07/08,10250000,17,0,18,-10250000,LaLiga
Real Murcia CF,07/08,9730000,26,2200000,21,-7530000,LaLiga
Recreativo Huelva,07/08,8540000,23,1200000,22,-7340000,LaLiga
Deportivo de La Coru?a,07/08,7950000,18,22000000,16,14050000,LaLiga
RCD Mallorca,07/08,7500000,16,11970000,12,4470000,LaLiga
Levante UD,07/08,5300000,30,1000000,24,-4300000,LaLiga
RCD Espanyol Barcelona,07/08,5100000,16,6850000,14,1750000,LaLiga
Real Valladolid CF,07/08,1900000,14,0,17,-1900000,LaLiga
FC Barcelona,08/09,96000000,10,54590000,12,-41410000,LaLiga
Real Madrid,08/09,82200000,13,71000000,12,-11200000,LaLiga
Sevilla FC,08/09,37700000,20,60550000,15,22850000,LaLiga
Real Betis Balompi?,08/09,34200000,17,11500000,14,-22700000,LaLiga
Atl?tico de Madrid,08/09,26500000,19,3450000,17,-23050000,LaLiga
Villarreal CF,08/09,26170000,23,24500000,17,-1670000,LaLiga
Getafe CF,08/09,17500000,15,8000000,15,-9500000,LaLiga
UD Almer?a,08/09,14500000,16,8000000,10,-6500000,LaLiga
RCD Espanyol Barcelona,08/09,14300000,15,18600000,14,4300000,LaLiga
RCD Mallorca,08/09,10230000,26,32400000,23,22170000,LaLiga
Deportivo de La Coru?a,08/09,9200000,22,20180000,19,10980000,LaLiga
Valencia CF,08/09,6600000,31,11300000,21,4700000,LaLiga
CA Osasuna,08/09,5050000,18,4750000,16,-300000,LaLiga
Recreativo Huelva,08/09,4990000,15,14300000,23,9310000,LaLiga
Racing Santander,08/09,3800000,25,17500000,24,13700000,LaLiga
Real Valladolid CF,08/09,1250000,16,5500000,18,4250000,LaLiga
M?laga CF,08/09,1100000,16,0,23,-1100000,LaLiga
Athletic Bilbao,08/09,325000,14,6000000,12,5675000,LaLiga
CD Numancia,08/09,300000,14,2000000,16,1700000,LaLiga
Sporting Gij?n,08/09,100000,11,0,11,-100000,LaLiga
Real Madrid,09/10,258500000,10,88500000,14,-170000000,LaLiga
FC Barcelona,09/10,113500000,12,24500000,10,-89000000,LaLiga
Sevilla FC,09/10,27500000,17,9300000,12,-18200000,LaLiga
Villarreal CF,09/10,22900000,14,11750000,15,-11150000,LaLiga
Atl?tico de Madrid,09/10,17250000,16,17900000,15,650000,LaLiga
Real Zaragoza,09/10,14900000,23,10920000,24,-3980000,LaLiga
Getafe CF,09/10,12250000,13,11400000,13,-850000,LaLiga
Real Valladolid CF,09/10,6680000,22,9500000,21,2820000,LaLiga
Racing Santander,09/10,6500000,22,8500000,22,2000000,LaLiga
RCD Espanyol Barcelona,09/10,5800000,26,8150000,19,2350000,LaLiga
UD Almer?a,09/10,5200000,12,7500000,9,2300000,LaLiga
Valencia CF,09/10,5000000,23,20630000,18,15630000,LaLiga
CA Osasuna,09/10,2460000,13,4000000,14,1540000,LaLiga
Athletic Bilbao,09/10,2350000,12,0,10,-2350000,LaLiga
Deportivo de La Coru?a,09/10,2100000,16,2700000,14,600000,LaLiga
M?laga CF,09/10,1600000,25,1150000,25,-450000,LaLiga
Sporting Gij?n,09/10,1400000,10,3300000,12,1900000,LaLiga
CD Tenerife,09/10,600000,8,0,10,-600000,LaLiga
Xerez CD,09/10,500000,12,0,27,-500000,LaLiga
RCD Mallorca,09/10,400000,21,9950000,17,9550000,LaLiga
Real Madrid,10/11,93000000,8,10500000,7,-82500000,LaLiga
FC Barcelona,10/11,72500000,15,52700000,9,-19800000,LaLiga
Atl?tico de Madrid,10/11,34050000,15,23900000,13,-10150000,LaLiga
Valencia CF,10/11,27850000,23,84350000,17,56500000,LaLiga
M?laga CF,10/11,25050000,29,0,26,-25050000,LaLiga
Sevilla FC,10/11,17100000,22,29600000,18,12500000,LaLiga
RCD Espanyol Barcelona,10/11,11250000,22,24500000,21,13250000,LaLiga
H?rcules CF,10/11,6210000,14,400000,15,-5810000,LaLiga
Real Zaragoza,10/11,4350000,18,2000000,22,-2350000,LaLiga
Villarreal CF,10/11,4250000,22,15820000,16,11570000,LaLiga
Real Sociedad,10/11,4200000,11,0,10,-4200000,LaLiga
Getafe CF,10/11,3900000,12,22100000,12,18200000,LaLiga
UD Almer?a,10/11,3200000,13,5000000,16,1800000,LaLiga
CA Osasuna,10/11,2790000,16,10250000,13,7460000,LaLiga
Athletic Bilbao,10/11,2720000,13,0,11,-2720000,LaLiga
Racing Santander,10/11,1470000,18,10000000,20,8530000,LaLiga
Sporting Gij?n,10/11,800000,10,0,10,-800000,LaLiga
Deportivo de La Coru?a,10/11,650000,21,16400000,17,15750000,LaLiga
RCD Mallorca,10/11,0,21,6400000,19,6400000,LaLiga
Levante UD,10/11,0,15,0,19,0,LaLiga
Atl?tico de Madrid,11/12,85200000,30,85350000,22,150000,LaLiga
FC Barcelona,11/12,60000000,13,46950000,12,-13050000,LaLiga
M?laga CF,11/12,59250000,21,0,16,-59250000,LaLiga
Real Madrid,11/12,56000000,9,8000000,7,-48000000,LaLiga
Valencia CF,11/12,34000000,18,32900000,16,-1100000,LaLiga
Villarreal CF,11/12,31300000,21,26850000,15,-4450000,LaLiga
Sevilla FC,11/12,19000000,25,15700000,20,-3300000,LaLiga
Granada CF,11/12,12190000,51,150000,39,-12040000,LaLiga
Real Zaragoza,11/12,11500000,24,15800000,30,4300000,LaLiga
Athletic Bilbao,11/12,7500000,10,0,7,-7500000,LaLiga
RCD Espanyol Barcelona,11/12,6500000,23,25000000,22,18500000,LaLiga
RCD Mallorca,11/12,3600000,13,9750000,14,6150000,LaLiga
Real Betis Balompi?,11/12,3440000,15,4500000,19,1060000,LaLiga
Getafe CF,11/12,3300000,22,18580000,19,15280000,LaLiga
CA Osasuna,11/12,2600000,19,8300000,17,5700000,LaLiga
Levante UD,11/12,1550000,18,8000000,26,6450000,LaLiga
Real Sociedad,11/12,1500000,10,0,11,-1500000,LaLiga
Sporting Gij?n,11/12,1500000,11,4500000,8,3000000,LaLiga
Racing Santander,11/12,350000,13,2100000,18,1750000,LaLiga
Rayo Vallecano,11/12,340000,18,1800000,23,1460000,LaLiga
Real Madrid,12/13,38500000,9,33500000,9,-5000000,LaLiga
FC Barcelona,12/13,33000000,10,500000,5,-32500000,LaLiga
Valencia CF,12/13,23200000,12,30000000,15,6800000,LaLiga
Sevilla FC,12/13,14000000,24,12200000,16,-1800000,LaLiga
Real Sociedad,12/13,14000000,9,500000,8,-13500000,LaLiga
Granada CF,12/13,13070000,57,7250000,48,-5820000,LaLiga
Getafe CF,12/13,5700000,21,5000000,20,-700000,LaLiga
Celta de Vigo,12/13,5150000,18,0,14,-5150000,LaLiga
Atl?tico de Madrid,12/13,4500000,21,21350000,16,16850000,LaLiga
RCD Mallorca,12/13,3700000,20,6000000,19,2300000,LaLiga
RCD Espanyol Barcelona,12/13,3350000,18,5700000,18,2350000,LaLiga
Real Betis Balompi?,12/13,2650000,19,0,19,-2650000,LaLiga
Athletic Bilbao,12/13,2500000,12,40000000,11,37500000,LaLiga
Real Zaragoza,12/13,1800000,27,1670000,23,-130000,LaLiga
Deportivo de La Coru?a,12/13,750000,16,0,22,-750000,LaLiga
Levante UD,12/13,650000,23,7940000,22,7290000,LaLiga
CA Osasuna,12/13,600000,23,5700000,20,5100000,LaLiga
Real Valladolid CF,12/13,0,10,0,17,0,LaLiga
Rayo Vallecano,12/13,0,22,2570000,24,2570000,LaLiga
M?laga CF,12/13,0,18,41600000,23,41600000,LaLiga
Real Madrid,13/14,175500000,12,113500000,10,-62000000,LaLiga
FC Barcelona,13/14,101000000,13,28100000,7,-72900000,LaLiga
Atl?tico de Madrid,13/14,36100000,27,70100000,20,34000000,LaLiga
Sevilla FC,13/14,35300000,37,90980000,33,55680000,LaLiga
Valencia CF,13/14,22470000,22,47100000,16,24630000,LaLiga
Villarreal CF,13/14,17450000,18,10500000,20,-6950000,LaLiga
Athletic Bilbao,13/14,15400000,17,0,11,-15400000,LaLiga
Getafe CF,13/14,10000000,17,14500000,18,4500000,LaLiga
Real Betis Balompi?,13/14,7450000,28,10030000,25,2580000,LaLiga
Real Sociedad,13/14,6500000,11,32000000,8,25500000,LaLiga
Celta de Vigo,13/14,6400000,20,10800000,23,4400000,LaLiga
Granada CF,13/14,5980000,52,6700000,45,720000,LaLiga
M?laga CF,13/14,5230000,24,37650000,24,32420000,LaLiga
CA Osasuna,13/14,3100000,15,4000000,16,900000,LaLiga
Elche CF,13/14,2230000,18,0,23,-2230000,LaLiga
Real Valladolid CF,13/14,1050000,11,1800000,11,750000,LaLiga
RCD Espanyol Barcelona,13/14,750000,20,12900000,18,12150000,LaLiga
Levante UD,13/14,300000,20,4620000,16,4320000,LaLiga
Rayo Vallecano,13/14,0,21,7000000,24,7000000,LaLiga
UD Almer?a,13/14,0,19,1000000,21,1000000,LaLiga
FC Barcelona,14/15,166720000,16,81800000,15,-84920000,LaLiga
Real Madrid,14/15,126000000,10,112100000,9,-13900000,LaLiga
Atl?tico de Madrid,14/15,120350000,32,89300000,26,-31050000,LaLiga
Valencia CF,14/15,55050000,28,55450000,31,400000,LaLiga
Sevilla FC,14/15,20950000,31,50550000,24,29600000,LaLiga
Villarreal CF,14/15,18700000,21,22500000,18,3800000,LaLiga
Real Sociedad,14/15,12000000,20,45200000,14,33200000,LaLiga
Granada CF,14/15,7920000,55,21000000,45,13080000,LaLiga
Celta de Vigo,14/15,3900000,14,1500000,11,-2400000,LaLiga
RCD Espanyol Barcelona,14/15,2500000,23,11000000,18,8500000,LaLiga
M?laga CF,14/15,1500000,16,18990000,16,17490000,LaLiga
Deportivo de La Coru?a,14/15,1400000,21,0,25,-1400000,LaLiga
Elche CF,14/15,1350000,18,6000000,22,4650000,LaLiga
Athletic Bilbao,14/15,1000000,17,36000000,11,35000000,LaLiga
Levante UD,14/15,800000,16,10000000,15,9200000,LaLiga
C?rdoba CF,14/15,750000,32,0,36,-750000,LaLiga
Rayo Vallecano,14/15,500000,24,650000,32,150000,LaLiga
SD Eibar,14/15,162000,26,600000,26,438000,LaLiga
UD Almer?a,14/15,0,18,3000000,20,3000000,LaLiga
Getafe CF,14/15,0,10,8000000,15,8000000,LaLiga
Valencia CF,15/16,143900000,25,50000000,18,-93900000,LaLiga
Atl?tico de Madrid,15/16,119000000,35,152000000,24,33000000,LaLiga
Real Madrid,15/16,92900000,21,31650000,12,-61250000,LaLiga
FC Barcelona,15/16,51000000,15,38300000,10,-12700000,LaLiga
Villarreal CF,15/16,47200000,24,37560000,21,-9640000,LaLiga
Sevilla FC,15/16,44000000,24,61450000,23,17450000,LaLiga
Real Sociedad,15/16,26100000,21,1000000,18,-25100000,LaLiga
Celta de Vigo,15/16,16300000,13,18500000,12,2200000,LaLiga
Athletic Bilbao,15/16,10000000,20,0,16,-10000000,LaLiga
Real Betis Balompi?,15/16,8850000,28,1050000,21,-7800000,LaLiga
M?laga CF,15/16,8650000,23,46800000,26,38150000,LaLiga
Deportivo de La Coru?a,15/16,8000000,21,0,25,-8000000,LaLiga
Levante UD,15/16,6550000,19,0,19,-6550000,LaLiga
UD Las Palmas,15/16,6400000,24,0,20,-6400000,LaLiga
RCD Espanyol Barcelona,15/16,4450000,30,15200000,23,10750000,LaLiga
Granada CF,15/16,3850000,50,11170000,50,7320000,LaLiga
SD Eibar,15/16,3700000,30,0,31,-3700000,LaLiga
Rayo Vallecano,15/16,400000,23,0,24,-400000,LaLiga
Getafe CF,15/16,270000,14,4100000,20,3830000,LaLiga
Sporting Gij?n,15/16,0,9,0,11,0,LaLiga
FC Barcelona,16/17,124750000,16,33800000,13,-90950000,LaLiga
Sevilla FC,16/17,81700000,20,93450000,23,11750000,LaLiga
Atl?tico de Madrid,16/17,78800000,35,44000000,21,-34800000,LaLiga
Villarreal CF,16/17,55950000,28,67250000,26,11300000,LaLiga
Valencia CF,16/17,36000000,23,121900000,24,85900000,LaLiga
Real Madrid,16/17,30000000,19,37500000,12,7500000,LaLiga
Real Betis Balompi?,16/17,20900000,25,8000000,26,-12900000,LaLiga
RCD Espanyol Barcelona,16/17,18400000,26,6000000,25,-12400000,LaLiga
Real Sociedad,16/17,18000000,18,11000000,12,-7000000,LaLiga
M?laga CF,16/17,12540000,23,0,20,-12540000,LaLiga
Granada CF,16/17,11580000,44,31600000,54,20020000,LaLiga
SD Eibar,16/17,8600000,30,5000000,24,-3600000,LaLiga
Celta de Vigo,16/17,8400000,17,19800000,9,11400000,LaLiga
Deportivo de La Coru?a,16/17,7000000,31,20000000,31,13000000,LaLiga
Deportivo Alav?s,16/17,6330000,19,0,25,-6330000,LaLiga
CD Legan?s,16/17,5450000,22,200000,31,-5250000,LaLiga
UD Las Palmas,16/17,2900000,19,200000,18,-2700000,LaLiga
CA Osasuna,16/17,2200000,15,3750000,13,1550000,LaLiga
Sporting Gij?n,16/17,1000000,19,0,21,-1000000,LaLiga
Athletic Bilbao,16/17,0,22,0,14,0,LaLiga
FC Barcelona,17/18,380100000,18,232500000,12,-147600000,LaLiga
Atl?tico de Madrid,17/18,95600000,23,104000000,21,8400000,LaLiga
Sevilla FC,17/18,78050000,19,81600000,20,3550000,LaLiga
Valencia CF,17/18,55000000,29,16550000,28,-38450000,LaLiga
Villarreal CF,17/18,46100000,20,68000000,18,21900000,LaLiga
Real Madrid,17/18,40500000,12,132500000,10,92000000,LaLiga
Real Betis Balompi?,17/18,38500000,26,27070000,25,-11430000,LaLiga
Athletic Bilbao,17/18,32000000,12,65000000,9,33000000,LaLiga
Celta de Vigo,17/18,26800000,22,13200000,21,-13600000,LaLiga
Real Sociedad,17/18,25500000,18,53000000,14,27500000,LaLiga
RCD Espanyol Barcelona,17/18,17050000,20,10500000,20,-6550000,LaLiga
Getafe CF,17/18,12900000,33,1600000,31,-11300000,LaLiga
Deportivo Alav?s,17/18,12330000,26,7500000,29,-4830000,LaLiga
M?laga CF,17/18,10500000,35,33400000,34,22900000,LaLiga
SD Eibar,17/18,10250000,30,10000000,23,-250000,LaLiga
Levante UD,17/18,10000000,28,13850000,26,3850000,LaLiga
Deportivo de La Coru?a,17/18,9500000,24,5500000,25,-4000000,LaLiga
Girona FC,17/18,8750000,23,0,26,-8750000,LaLiga
CD Legan?s,17/18,6550000,24,130000,31,-6420000,LaLiga
UD Las Palmas,17/18,350000,28,25700000,30,25350000,LaLiga
Atl?tico de Madrid,18/19,168000000,28,57900000,19,-110100000,LaLiga
Real Madrid,18/19,164750000,24,136100000,14,-28650000,LaLiga
FC Barcelona,18/19,141100000,27,146050000,21,4950000,LaLiga
Valencia CF,18/19,129200000,31,68800000,24,-60400000,LaLiga
Villarreal CF,18/19,92900000,31,54800000,24,-38100000,LaLiga
Sevilla FC,18/19,81050000,27,93800000,26,12750000,LaLiga
Real Betis Balompi?,18/19,44500000,27,49300000,22,4800000,LaLiga
Athletic Bilbao,18/19,32900000,16,80000000,9,47100000,LaLiga
Celta de Vigo,18/19,30000000,29,35700000,21,5700000,LaLiga
Getafe CF,18/19,27250000,35,5000000,31,-22250000,LaLiga
Levante UD,18/19,26700000,23,41500000,25,14800000,LaLiga
RCD Espanyol Barcelona,18/19,22100000,16,30800000,15,8700000,LaLiga
CD Legan?s,18/19,18900000,37,24600000,38,5700000,LaLiga
Rayo Vallecano,18/19,12300000,32,13000000,32,700000,LaLiga
Real Sociedad,18/19,12000000,14,32800000,16,20800000,LaLiga
Girona FC,18/19,10200000,13,3300000,14,-6900000,LaLiga
Real Valladolid CF,18/19,10100000,27,0,27,-10100000,LaLiga
Deportivo Alav?s,18/19,10000000,34,9000000,32,-1000000,LaLiga
SD Huesca,18/19,9300000,27,400000,34,-8900000,LaLiga
SD Eibar,18/19,8000000,20,7750000,20,-250000,LaLiga
Real Madrid,19/20,355500000,34,136800000,23,-218700000,LaLiga
FC Barcelona,19/20,298500000,30,152900000,23,-145600000,LaLiga
Atl?tico de Madrid,19/20,247350000,25,316300000,20,68950000,LaLiga
Sevilla FC,19/20,188730000,41,131450000,34,-57280000,LaLiga
Real Betis Balompi?,19/20,96450000,28,72000000,21,-24450000,LaLiga
Valencia CF,19/20,75000000,29,56300000,23,-18700000,LaLiga
RCD Espanyol Barcelona,19/20,61500000,21,59000000,18,-2500000,LaLiga
Villarreal CF,19/20,43800000,28,69300000,21,25500000,LaLiga
Real Sociedad,19/20,31750000,20,9500000,14,-22250000,LaLiga
Celta de Vigo,19/20,24600000,22,40650000,21,16050000,LaLiga
Getafe CF,19/20,21500000,30,11250000,23,-10250000,LaLiga
SD Eibar,19/20,17300000,24,27000000,18,9700000,LaLiga
CD Legan?s,19/20,16450000,43,40820000,47,24370000,LaLiga
Levante UD,19/20,14600000,29,14900000,22,300000,LaLiga
CA Osasuna,19/20,14450000,27,300000,21,-14150000,LaLiga
Deportivo Alav?s,19/20,11770000,39,22500000,32,10730000,LaLiga
Granada CF,19/20,11240000,22,300000,23,-10940000,LaLiga
RCD Mallorca,19/20,7500000,45,0,35,-7500000,LaLiga
Real Valladolid CF,19/20,1400000,29,8000000,27,6600000,LaLiga
Athletic Bilbao,19/20,0,15,0,12,0,LaLiga
FC Barcelona,20/21,112000000,22,149800000,15,37800000,LaLiga
Atl?tico de Madrid,20/21,91000000,22,83300000,17,-7700000,LaLiga
Sevilla FC,20/21,73650000,31,19680000,19,-53970000,LaLiga
Villarreal CF,20/21,36500000,33,26650000,21,-9850000,LaLiga
Getafe CF,20/21,22050000,25,9750000,29,-12300000,LaLiga
Granada CF,20/21,20500000,15,0,18,-20500000,LaLiga
Athletic Bilbao,20/21,12000000,15,0,9,-12000000,LaLiga
C?diz CF,20/21,10100000,39,0,35,-10100000,LaLiga
Real Sociedad,20/21,10000000,13,28250000,7,18250000,LaLiga
Real Valladolid CF,20/21,9850000,38,12100000,27,2250000,LaLiga
CA Osasuna,20/21,9150000,20,3450000,20,-5700000,LaLiga
Elche CF,20/21,6100000,24,7300000,23,1200000,LaLiga
SD Huesca,20/21,4650000,25,0,24,-4650000,LaLiga
Levante UD,20/21,4000000,20,5000000,14,1000000,LaLiga
Celta de Vigo,20/21,3000000,15,2500000,15,-500000,LaLiga
SD Eibar,20/21,2000000,17,150000,19,-1850000,LaLiga
Valencia CF,20/21,50000,17,87850000,16,87800000,LaLiga
Real Betis Balompi?,20/21,0,18,43700000,15,43700000,LaLiga
Real Madrid,20/21,0,22,104200000,19,104200000,LaLiga
Deportivo Alav?s,20/21,0,32,4880000,28,4880000,LaLiga
Atl?tico de Madrid,21/22,80700000,30,22750000,19,-57950000,LaLiga
FC Barcelona,21/22,69500000,25,70760000,19,1260000,LaLiga
Villarreal CF,21/22,54500000,28,10380000,24,-44120000,LaLiga
Sevilla FC,21/22,41500000,23,28500000,18,-13000000,LaLiga
Real Madrid,21/22,31000000,15,78000000,7,47000000,LaLiga
Granada CF,21/22,17450000,26,3000000,20,-14450000,LaLiga
Getafe CF,21/22,16000000,28,21000000,27,5000000,LaLiga
Valencia CF,21/22,13350000,19,2700000,22,-10650000,LaLiga
Celta de Vigo,21/22,10020000,18,1800000,19,-8220000,LaLiga
RCD Mallorca,21/22,10000000,27,9000000,29,-1000000,LaLiga
CA Osasuna,21/22,8700000,17,0,16,-8700000,LaLiga
Elche CF,21/22,8200000,24,2100000,23,-6100000,LaLiga
C?diz CF,21/22,6100000,32,0,27,-6100000,LaLiga
RCD Espanyol Barcelona,21/22,6000000,15,0,12,-6000000,LaLiga
Rayo Vallecano,21/22,4300000,25,2200000,25,-2100000,LaLiga
Real Betis Balompi?,21/22,3250000,12,14000000,10,10750000,LaLiga
Real Sociedad,21/22,2500000,12,0,11,-2500000,LaLiga
Deportivo Alav?s,21/22,1150000,30,3500000,28,2350000,LaLiga
Levante UD,21/22,875000,16,0,10,-875000,LaLiga
Athletic Bilbao,21/22,0,12,0,9,0,LaLiga
FC Barcelona,22/23,158000000,24,39000000,22,-119000000,LaLiga
Real Madrid,22/23,80000000,13,92150000,12,12150000,LaLiga
Real Sociedad,22/23,53000000,23,80500000,17,27500000,LaLiga
UD Almer?a,22/23,37080000,30,22200000,25,-14880000,LaLiga
Atl?tico de Madrid,22/23,29500000,32,20250000,23,-9250000,LaLiga
Sevilla FC,22/23,29400000,31,91500000,26,62100000,LaLiga
Real Betis Balompi?,22/23,25000000,13,14750000,13,-10250000,LaLiga
Celta de Vigo,22/23,22350000,30,17200000,22,-5150000,LaLiga
RCD Espanyol Barcelona,22/23,20600000,30,14800000,28,-5800000,LaLiga
Getafe CF,22/23,15750000,27,20500000,27,4750000,LaLiga
Girona FC,22/23,15000000,26,0,26,-15000000,LaLiga
Elche CF,22/23,13160000,23,5500000,21,-7660000,LaLiga
RCD Mallorca,22/23,13100000,22,4300000,25,-8800000,LaLiga
Valencia CF,22/23,12500000,16,54600000,20,42100000,LaLiga
Rayo Vallecano,22/23,11300000,23,200000,17,-11100000,LaLiga
C?diz CF,22/23,9500000,34,1000000,28,-8500000,LaLiga
Villarreal CF,22/23,6480000,21,31600000,19,25120000,LaLiga
Real Valladolid CF,22/23,6300000,35,1300000,30,-5000000,LaLiga
CA Osasuna,22/23,2000000,13,0,16,-2000000,LaLiga
Athletic Bilbao,22/23,0,22,0,13,0,LaLiga
Bayer 04 Leverkusen,02/03,30400000,20,15950000,15,-14450000,Bundesliga
Bayern Munich,02/03,24500000,6,3500000,7,-21000000,Bundesliga
FC Schalke 04,02/03,19250000,9,200000,13,-19050000,Bundesliga
Borussia Dortmund,02/03,10150000,7,1550000,11,-8600000,Bundesliga
SV Werder Bremen,02/03,5950000,13,14950000,11,9000000,Bundesliga
Hannover 96,02/03,5800000,18,6540000,19,740000,Bundesliga
1.FC Kaiserslautern,02/03,4900000,7,0,8,-4900000,Bundesliga
Hamburger SV,02/03,4200000,12,250000,8,-3950000,Bundesliga
Borussia M?nchengladbach,02/03,3950000,7,635000,11,-3315000,Bundesliga
FC Hansa Rostock,02/03,2730000,12,100000,14,-2630000,Bundesliga
Hertha BSC,02/03,2550000,9,9250000,6,6700000,Bundesliga
TSV 1860 Munich,02/03,2230000,10,4450000,10,2220000,Bundesliga
VfL Wolfsburg,02/03,2140000,14,250000,17,-1890000,Bundesliga
Arminia Bielefeld,02/03,900000,13,2050000,14,1150000,Bundesliga
FC Energie Cottbus,02/03,900000,11,1200000,16,300000,Bundesliga
1.FC Nuremberg,02/03,200000,9,0,7,-200000,Bundesliga
VfB Stuttgart,02/03,150000,5,0,4,-150000,Bundesliga
VfL Bochum,02/03,0,8,275000,10,275000,Bundesliga
Bayern Munich,03/04,27000000,7,4500000,9,-22500000,Bundesliga
Borussia Dortmund,03/04,16570000,14,3700000,9,-12870000,Bundesliga
VfL Wolfsburg,03/04,14500000,15,3020000,21,-11480000,Bundesliga
VfB Stuttgart,03/04,8000000,15,350000,12,-7650000,Bundesliga
Hannover 96,03/04,5030000,27,300000,24,-4730000,Bundesliga
1.FC Kaiserslautern,03/04,3520000,15,0,11,-3520000,Bundesliga
Borussia M?nchengladbach,03/04,2300000,14,175000,16,-2125000,Bundesliga
Hamburger SV,03/04,2200000,13,400000,15,-1800000,Bundesliga
FC Schalke 04,03/04,2000000,9,2150000,6,150000,Bundesliga
TSV 1860 Munich,03/04,1830000,9,2870000,11,1040000,Bundesliga
VfL Bochum,03/04,700000,9,2650000,10,1950000,Bundesliga
SV Werder Bremen,03/04,450000,9,160000,10,-290000,Bundesliga
FC Hansa Rostock,03/04,430000,7,0,6,-430000,Bundesliga
Eintracht Frankfurt,03/04,325000,17,300000,16,-25000,Bundesliga
Bayer 04 Leverkusen,03/04,300000,21,50000,20,-250000,Bundesliga
1. FC K?ln,03/04,100000,14,0,14,-100000,Bundesliga
Hertha BSC,03/04,25000,12,500000,12,475000,Bundesliga
SC Freiburg,03/04,11000,11,0,8,-11000,Bundesliga
Bayern Munich,04/05,25750000,7,1030000,3,-24720000,Bundesliga
Hamburger SV,04/05,13150000,17,8400000,19,-4750000,Bundesliga
SV Werder Bremen,04/05,9000000,12,6450000,16,-2550000,Bundesliga
VfL Wolfsburg,04/05,8500000,11,0,10,-8500000,Bundesliga
FC Schalke 04,04/05,4650000,14,50000,13,-4600000,Bundesliga
Borussia M?nchengladbach,04/05,3830000,23,1500000,19,-2330000,Bundesliga
Bayer 04 Leverkusen,04/05,3750000,22,15750000,21,12000000,Bundesliga
VfL Bochum,04/05,2740000,14,5750000,10,3010000,Bundesliga
1.FSV Mainz 05,04/05,2600000,10,650000,12,-1950000,Bundesliga
Hertha BSC,04/05,2550000,11,1280000,11,-1270000,Bundesliga
1.FC Nuremberg,04/05,2250000,14,150000,18,-2100000,Bundesliga
VfB Stuttgart,04/05,2150000,8,4250000,10,2100000,Bundesliga
Hannover 96,04/05,1880000,23,650000,20,-1230000,Bundesliga
Arminia Bielefeld,04/05,1420000,16,200000,14,-1220000,Bundesliga
SC Freiburg,04/05,1400000,10,50000,6,-1350000,Bundesliga
1.FC Kaiserslautern,04/05,550000,14,6000000,17,5450000,Bundesliga
FC Hansa Rostock,04/05,550000,9,500000,8,-50000,Bundesliga
Borussia Dortmund,04/05,0,10,10150000,10,10150000,Bundesliga
SV Werder Bremen,05/06,15190000,17,11000000,13,-4190000,Bundesliga
FC Schalke 04,05/06,14200000,11,8080000,12,-6120000,Bundesliga
VfB Stuttgart,05/06,11550000,15,29000000,17,17450000,Bundesliga
Bayern Munich,05/06,11200000,7,7050000,7,-4150000,Bundesliga
VfL Wolfsburg,05/06,9980000,14,12800000,13,2820000,Bundesliga
Hamburger SV,05/06,9750000,19,3600000,16,-6150000,Bundesliga
1. FC K?ln,05/06,5550000,21,400000,19,-5150000,Bundesliga
Hannover 96,05/06,5350000,16,300000,18,-5050000,Bundesliga
Borussia M?nchengladbach,05/06,5150000,19,2400000,20,-2750000,Bundesliga
Bayer 04 Leverkusen,05/06,4250000,16,5810000,13,1560000,Bundesliga
Eintracht Frankfurt,05/06,4030000,15,0,14,-4030000,Bundesliga
Arminia Bielefeld,05/06,3800000,14,3730000,20,-70000,Bundesliga
1.FC Nuremberg,05/06,2330000,11,145000,12,-2185000,Bundesliga
MSV Duisburg,05/06,2200000,16,0,13,-2200000,Bundesliga
Borussia Dortmund,05/06,1730000,13,4250000,13,2520000,Bundesliga
1.FC Kaiserslautern,05/06,1200000,16,1800000,15,600000,Bundesliga
1.FSV Mainz 05,05/06,750000,11,1340000,12,590000,Bundesliga
Hertha BSC,05/06,425000,11,0,12,-425000,Bundesliga
Hamburger SV,06/07,30300000,19,22630000,14,-7670000,Bundesliga
Bayern Munich,06/07,24000000,7,2500000,8,-21500000,Bundesliga
SV Werder Bremen,06/07,15350000,13,10700000,12,-4650000,Bundesliga
VfB Stuttgart,06/07,14700000,25,8650000,16,-6050000,Bundesliga
Borussia Dortmund,06/07,12200000,11,16950000,10,4750000,Bundesliga
Borussia M?nchengladbach,06/07,10350000,13,500000,11,-9850000,Bundesliga
VfL Wolfsburg,06/07,10200000,15,920000,11,-9280000,Bundesliga
Bayer 04 Leverkusen,06/07,9280000,10,17550000,6,8270000,Bundesliga
1.FSV Mainz 05,06/07,4900000,25,4490000,20,-410000,Bundesliga
Hertha BSC,06/07,3100000,16,4650000,14,1550000,Bundesliga
Eintracht Frankfurt,06/07,2290000,9,680000,9,-1610000,Bundesliga
VfL Bochum,06/07,1950000,16,1500000,17,-450000,Bundesliga
Arminia Bielefeld,06/07,1900000,13,1230000,12,-670000,Bundesliga
Hannover 96,06/07,1500000,14,4730000,15,3230000,Bundesliga
1.FC Nuremberg,06/07,1250000,19,7430000,16,6180000,Bundesliga
Alemannia Aachen,06/07,900000,7,50000,8,-850000,Bundesliga
FC Energie Cottbus,06/07,560000,15,200000,9,-360000,Bundesliga
FC Schalke 04,06/07,0,16,2920000,13,2920000,Bundesliga
Bayern Munich,07/08,93200000,14,36150000,12,-57050000,Bundesliga
VfL Wolfsburg,07/08,30710000,25,14410000,22,-16300000,Bundesliga
SV Werder Bremen,07/08,26100000,16,23010000,11,-3090000,Bundesliga
FC Schalke 04,07/08,17800000,14,14510000,12,-3290000,Bundesliga
Hertha BSC,07/08,17350000,20,18800000,21,1450000,Bundesliga
Bayer 04 Leverkusen,07/08,14600000,11,7420000,13,-7180000,Bundesliga
Hamburger SV,07/08,12250000,15,8910000,15,-3340000,Bundesliga
Borussia Dortmund,07/08,10700000,13,5280000,10,-5420000,Bundesliga
VfB Stuttgart,07/08,10700000,24,3700000,20,-7000000,Bundesliga
Hannover 96,07/08,9600000,14,1010000,13,-8590000,Bundesliga
Eintracht Frankfurt,07/08,7600000,8,4750000,9,-2850000,Bundesliga
1.FC Nuremberg,07/08,6700000,13,6350000,15,-350000,Bundesliga
VfL Bochum,07/08,4800000,18,4700000,20,-100000,Bundesliga
MSV Duisburg,07/08,3400000,21,750000,15,-2650000,Bundesliga
FC Energie Cottbus,07/08,3250000,18,5930000,17,2680000,Bundesliga
Arminia Bielefeld,07/08,1850000,13,3530000,10,1680000,Bundesliga
Karlsruher SC,07/08,900000,9,0,8,-900000,Bundesliga
FC Hansa Rostock,07/08,700000,12,0,11,-700000,Bundesliga
Hamburger SV,08/09,34450000,20,45200000,17,10750000,Bundesliga
VfL Wolfsburg,08/09,33100000,28,4530000,22,-28570000,Bundesliga
FC Schalke 04,08/09,15750000,9,9000000,11,-6750000,Bundesliga
Borussia Dortmund,08/09,13750000,16,12300000,19,-1450000,Bundesliga
TSG 1899 Hoffenheim,08/09,11950000,11,125000,17,-11825000,Bundesliga
Borussia M?nchengladbach,08/09,11550000,15,670000,11,-10880000,Bundesliga
Bayer 04 Leverkusen,08/09,10250000,20,4000000,15,-6250000,Bundesliga
VfB Stuttgart,08/09,9600000,15,13100000,14,3500000,Bundesliga
1. FC K?ln,08/09,7150000,13,750000,14,-6400000,Bundesliga
Eintracht Frankfurt,08/09,6650000,9,1020000,7,-5630000,Bundesliga
Hannover 96,08/09,6400000,12,3140000,9,-3260000,Bundesliga
Hertha BSC,08/09,6400000,18,2900000,14,-3500000,Bundesliga
SV Werder Bremen,08/09,5800000,14,3400000,11,-2400000,Bundesliga
VfL Bochum,08/09,4750000,12,8000,12,-4742000,Bundesliga
Arminia Bielefeld,08/09,3200000,15,1830000,19,-1370000,Bundesliga
FC Energie Cottbus,08/09,2600000,17,720000,16,-1880000,Bundesliga
Karlsruher SC,08/09,1900000,7,2900000,8,1000000,Bundesliga
Bayern Munich,08/09,0,9,10900000,13,10900000,Bundesliga
Bayern Munich,09/10,75700000,19,22950000,12,-52750000,Bundesliga
Hamburger SV,09/10,30450000,22,8500000,18,-21950000,Bundesliga
VfL Wolfsburg,09/10,27300000,18,3400000,15,-23900000,Bundesliga
VfB Stuttgart,09/10,18100000,13,30950000,12,12850000,Bundesliga
TSG 1899 Hoffenheim,09/10,16250000,14,225000,9,-16025000,Bundesliga
SV Werder Bremen,09/10,13000000,22,32380000,16,19380000,Bundesliga
1. FC K?ln,09/10,11500000,14,900000,11,-10600000,Bundesliga
Borussia Dortmund,09/10,10900000,15,6350000,8,-4550000,Bundesliga
Borussia M?nchengladbach,09/10,10500000,12,8400000,11,-2100000,Bundesliga
FC Schalke 04,09/10,8500000,26,4800000,10,-3700000,Bundesliga
Bayer 04 Leverkusen,09/10,6550000,18,1600000,17,-4950000,Bundesliga
Hertha BSC,09/10,4510000,19,8550000,22,4040000,Bundesliga
1.FSV Mainz 05,09/10,3600000,14,200000,13,-3400000,Bundesliga
SC Freiburg,09/10,3150000,16,445000,10,-2705000,Bundesliga
VfL Bochum,09/10,2100000,12,250000,12,-1850000,Bundesliga
Hannover 96,09/10,2050000,12,800000,10,-1250000,Bundesliga
Eintracht Frankfurt,09/10,1250000,16,600000,10,-650000,Bundesliga
1.FC Nuremberg,09/10,450000,14,2350000,18,1900000,Bundesliga
VfL Wolfsburg,10/11,56150000,20,59650000,18,3500000,Bundesliga
FC Schalke 04,10/11,36100000,27,20050000,27,-16050000,Bundesliga
TSG 1899 Hoffenheim,10/11,22450000,18,45400000,17,22950000,Bundesliga
Bayern Munich,10/11,17000000,10,6000000,10,-11000000,Bundesliga
SV Werder Bremen,10/11,16240000,20,21500000,12,5260000,Bundesliga
Hamburger SV,10/11,15200000,20,15550000,12,350000,Bundesliga
VfB Stuttgart,10/11,13100000,14,20500000,17,7400000,Bundesliga
Borussia M?nchengladbach,10/11,7000000,15,2000000,12,-5000000,Bundesliga
Bayer 04 Leverkusen,10/11,5700000,20,6550000,15,850000,Bundesliga
Borussia Dortmund,10/11,5250000,16,4300000,12,-950000,Bundesliga
1.FC Kaiserslautern,10/11,4600000,19,100000,23,-4500000,Bundesliga
1. FC K?ln,10/11,4600000,22,50000,14,-4550000,Bundesliga
1.FSV Mainz 05,10/11,3800000,19,5120000,25,1320000,Bundesliga
Eintracht Frankfurt,10/11,2450000,13,1150000,15,-1300000,Bundesliga
SC Freiburg,10/11,1450000,14,210000,14,-1240000,Bundesliga
1.FC Nuremberg,10/11,1150000,22,2750000,21,1600000,Bundesliga
Hannover 96,10/11,1000000,11,550000,17,-450000,Bundesliga
FC St. Pauli,10/11,200000,6,0,11,-200000,Bundesliga
Bayern Munich,11/12,52100000,8,5000000,6,-47100000,Bundesliga
VfL Wolfsburg,11/12,48800000,36,12130000,19,-36670000,Bundesliga
Bayer 04 Leverkusen,11/12,26110000,22,16060000,17,-10050000,Bundesliga
Hamburger SV,11/12,13900000,24,17350000,18,3450000,Bundesliga
VfB Stuttgart,11/12,11100000,11,18400000,12,7300000,Bundesliga
1.FSV Mainz 05,11/12,10900000,22,17950000,17,7050000,Bundesliga
Borussia Dortmund,11/12,9730000,13,12140000,11,2410000,Bundesliga
SV Werder Bremen,11/12,8800000,18,20250000,20,11450000,Bundesliga
FC Schalke 04,11/12,7300000,20,34080000,17,26780000,Bundesliga
1.FC Kaiserslautern,11/12,6630000,18,4450000,21,-2180000,Bundesliga
TSG 1899 Hoffenheim,11/12,5900000,23,7500000,15,1600000,Bundesliga
1. FC K?ln,11/12,5880000,27,2880000,22,-3000000,Bundesliga
Hannover 96,11/12,4200000,10,0,7,-4200000,Bundesliga
1.FC Nuremberg,11/12,4150000,19,5500000,18,1350000,Bundesliga
SC Freiburg,11/12,3500000,17,15300000,17,11800000,Bundesliga
Borussia M?nchengladbach,11/12,2650000,22,3830000,21,1180000,Bundesliga
Hertha BSC,11/12,1400000,16,1000000,10,-400000,Bundesliga
FC Augsburg,11/12,1180000,15,260000,14,-920000,Bundesliga
Bayern Munich,12/13,70300000,12,500000,7,-69800000,Bundesliga
Borussia M?nchengladbach,12/13,33400000,16,24050000,14,-9350000,Bundesliga
VfL Wolfsburg,12/13,27100000,36,21850000,28,-5250000,Bundesliga
Hamburger SV,12/13,27000000,14,9600000,18,-17400000,Bundesliga
Borussia Dortmund,12/13,26650000,15,34000000,12,7350000,Bundesliga
TSG 1899 Hoffenheim,12/13,26300000,31,20250000,25,-6050000,Bundesliga
Bayer 04 Leverkusen,12/13,20900000,23,14680000,19,-6220000,Bundesliga
SV Werder Bremen,12/13,14730000,14,13100000,17,-1630000,Bundesliga
Hannover 96,12/13,9550000,14,3170000,12,-6380000,Bundesliga
Eintracht Frankfurt,12/13,8150000,22,3000000,20,-5150000,Bundesliga
FC Schalke 04,12/13,6500000,23,6850000,23,350000,Bundesliga
1.FSV Mainz 05,12/13,4180000,14,5950000,13,1770000,Bundesliga
SpVgg Greuther F?rth,12/13,3850000,25,2340000,21,-1510000,Bundesliga
Fortuna D?sseldorf,12/13,3050000,25,0,23,-3050000,Bundesliga
FC Augsburg,12/13,2850000,16,150000,20,-2700000,Bundesliga
1.FC Nuremberg,12/13,2700000,18,7000000,16,4300000,Bundesliga
VfB Stuttgart,12/13,2400000,14,9700000,11,7300000,Bundesliga
SC Freiburg,12/13,1500000,13,200000,12,-1300000,Bundesliga
Bayern Munich,13/14,62000000,8,40000000,7,-22000000,Bundesliga
Borussia Dortmund,13/14,52600000,13,47380000,12,-5220000,Bundesliga
VfL Wolfsburg,13/14,50600000,33,16050000,30,-34550000,Bundesliga
FC Schalke 04,13/14,26050000,16,8100000,15,-17950000,Bundesliga
Bayer 04 Leverkusen,13/14,24980000,23,35570000,19,10590000,Bundesliga
1.FSV Mainz 05,13/14,14200000,16,11550000,14,-2650000,Bundesliga
Hannover 96,13/14,10500000,20,4700000,20,-5800000,Bundesliga
SV Werder Bremen,13/14,10250000,14,13600000,13,3350000,Bundesliga
TSG 1899 Hoffenheim,13/14,9900000,32,4000000,25,-5900000,Bundesliga
Borussia M?nchengladbach,13/14,7900000,12,3250000,9,-4650000,Bundesliga
Eintracht Frankfurt,13/14,7480000,16,500000,14,-6980000,Bundesliga
1.FC Nuremberg,13/14,7320000,19,6750000,18,-570000,Bundesliga
VfB Stuttgart,13/14,7200000,17,7200000,19,0,Bundesliga
SC Freiburg,13/14,6930000,17,12200000,17,5270000,Bundesliga
FC Augsburg,13/14,4550000,17,600000,16,-3950000,Bundesliga
Hamburger SV,13/14,2350000,16,13750000,14,11400000,Bundesliga
Eintracht Braunschweig,13/14,1800000,12,0,11,-1800000,Bundesliga
Hertha BSC,13/14,1300000,13,350000,15,-950000,Bundesliga
Borussia Dortmund,14/15,65200000,12,4800000,8,-60400000,Bundesliga
Bayern Munich,14/15,53400000,13,48700000,10,-4700000,Bundesliga
VfL Wolfsburg,14/15,45050000,18,6250000,13,-38800000,Bundesliga
Bayer 04 Leverkusen,14/15,39310000,29,18350000,26,-20960000,Bundesliga
Hamburger SV,14/15,35800000,24,23900000,21,-11900000,Bundesliga
TSG 1899 Hoffenheim,14/15,19200000,29,14420000,26,-4780000,Bundesliga
Hertha BSC,14/15,14500000,16,19450000,12,4950000,Bundesliga
SC Freiburg,14/15,14430000,18,18600000,19,4170000,Bundesliga
Borussia M?nchengladbach,14/15,12750000,12,17900000,11,5150000,Bundesliga
FC Augsburg,14/15,12450000,17,6900000,16,-5550000,Bundesliga
Hannover 96,14/15,10800000,23,3500000,18,-7300000,Bundesliga
VfB Stuttgart,14/15,10800000,15,750000,12,-10050000,Bundesliga
1.FSV Mainz 05,14/15,9120000,24,6600000,20,-2520000,Bundesliga
1. FC K?ln,14/15,8400000,16,100000,16,-8300000,Bundesliga
SV Werder Bremen,14/15,6550000,23,3350000,20,-3200000,Bundesliga
Eintracht Frankfurt,14/15,6500000,17,5930000,20,-570000,Bundesliga
FC Schalke 04,14/15,4400000,16,8600000,13,4200000,Bundesliga
SC Paderborn 07,14/15,1950000,16,0,14,-1950000,Bundesliga
Bayern Munich,15/16,90750000,11,33000000,11,-57750000,Bundesliga
VfL Wolfsburg,15/16,68100000,15,111300000,13,43200000,Bundesliga
Bayer 04 Leverkusen,15/16,58000000,30,63250000,18,5250000,Bundesliga
Borussia M?nchengladbach,15/16,38000000,14,15700000,11,-22300000,Bundesliga
FC Schalke 04,15/16,37100000,20,57200000,19,20100000,Bundesliga
TSG 1899 Hoffenheim,15/16,23400000,39,57150000,30,33750000,Bundesliga
Hamburger SV,15/16,21850000,23,13200000,20,-8650000,Bundesliga
Borussia Dortmund,15/16,20000000,14,42550000,16,22550000,Bundesliga
Hannover 96,15/16,18400000,26,13500000,21,-4900000,Bundesliga
FC Augsburg,15/16,16700000,17,26900000,11,10200000,Bundesliga
VfB Stuttgart,15/16,15670000,22,20550000,21,4880000,Bundesliga
1. FC K?ln,15/16,14780000,13,13050000,16,-1730000,Bundesliga
1.FSV Mainz 05,15/16,13850000,27,34200000,25,20350000,Bundesliga
SV Werder Bremen,15/16,12880000,26,19450000,19,6570000,Bundesliga
Eintracht Frankfurt,15/16,11820000,16,12100000,14,280000,Bundesliga
Hertha BSC,15/16,7300000,15,4920000,12,-2380000,Bundesliga
FC Ingolstadt 04,15/16,6200000,6,0,9,-6200000,Bundesliga
SV Darmstadt 98,15/16,1100000,16,0,12,-1100000,Bundesliga
Borussia Dortmund,16/17,141100000,15,111000000,8,-30100000,Bundesliga
RB Leipzig,16/17,95950000,15,100000,14,-95850000,Bundesliga
VfL Wolfsburg,16/17,81050000,24,94450000,21,13400000,Bundesliga
Bayern Munich,16/17,70000000,8,52300000,9,-17700000,Bundesliga
Bayer 04 Leverkusen,16/17,63300000,29,23700000,19,-39600000,Bundesliga
Hamburger SV,16/17,43950000,22,8750000,18,-35200000,Bundesliga
FC Schalke 04,16/17,43300000,23,61300000,19,18000000,Bundesliga
Borussia M?nchengladbach,16/17,41250000,15,45100000,11,3850000,Bundesliga
1.FSV Mainz 05,16/17,29210000,21,25700000,18,-3510000,Bundesliga
TSG 1899 Hoffenheim,16/17,27440000,30,37000000,25,9560000,Bundesliga
SV Werder Bremen,16/17,23700000,24,27200000,21,3500000,Bundesliga
FC Augsburg,16/17,23700000,18,15050000,18,-8650000,Bundesliga
SC Freiburg,16/17,16780000,22,5150000,21,-11630000,Bundesliga
1. FC K?ln,16/17,8350000,11,19000000,9,10650000,Bundesliga
FC Ingolstadt 04,16/17,7950000,14,4550000,11,-3400000,Bundesliga
Hertha BSC,16/17,6700000,7,5000000,11,-1700000,Bundesliga
SV Darmstadt 98,16/17,4100000,26,5200000,29,1100000,Bundesliga
Eintracht Frankfurt,16/17,3800000,16,12050000,21,8250000,Bundesliga
Borussia Dortmund,17/18,122590000,19,275950000,16,153360000,Bundesliga
Bayern Munich,17/18,116500000,17,32250000,11,-84250000,Bundesliga
VfL Wolfsburg,17/18,72750000,26,36000000,23,-36750000,Bundesliga
RB Leipzig,17/18,63500000,25,24540000,15,-38960000,Bundesliga
Bayer 04 Leverkusen,17/18,51000000,15,91100000,18,40100000,Bundesliga
FC Schalke 04,17/18,49300000,24,7100000,25,-42200000,Bundesliga
1. FC K?ln,17/18,40000000,11,7450000,5,-32550000,Bundesliga
Borussia M?nchengladbach,17/18,37250000,14,31080000,14,-6170000,Bundesliga
VfB Stuttgart,17/18,30900000,23,7600000,20,-23300000,Bundesliga
SC Freiburg,17/18,19650000,22,27800000,16,8150000,Bundesliga
Eintracht Frankfurt,17/18,19200000,18,4920000,16,-14280000,Bundesliga
Hamburger SV,17/18,19000000,18,5550000,16,-13450000,Bundesliga
Hannover 96,17/18,19000000,19,250000,15,-18750000,Bundesliga
SV Werder Bremen,17/18,18600000,23,8900000,20,-9700000,Bundesliga
1.FSV Mainz 05,17/18,16550000,21,24850000,19,8300000,Bundesliga
TSG 1899 Hoffenheim,17/18,14700000,28,45750000,21,31050000,Bundesliga
Hertha BSC,17/18,14000000,13,18000000,10,4000000,Bundesliga
FC Augsburg,17/18,7550000,20,7900000,18,350000,Bundesliga
Borussia Dortmund,18/19,90500000,20,114200000,19,23700000,Bundesliga
RB Leipzig,18/19,65630000,19,72750000,18,7120000,Bundesliga
FC Schalke 04,18/19,62200000,20,46150000,16,-16050000,Bundesliga
VfB Stuttgart,18/19,45760000,25,13250000,19,-32510000,Bundesliga
VfL Wolfsburg,18/19,36000000,19,800000,14,-35200000,Bundesliga
Borussia M?nchengladbach,18/19,32550000,12,32950000,10,400000,Bundesliga
TSG 1899 Hoffenheim,18/19,32000000,25,6120000,19,-25880000,Bundesliga
Bayer 04 Leverkusen,18/19,31500000,12,45000000,9,13500000,Bundesliga
1.FSV Mainz 05,18/19,30000000,22,56100000,13,26100000,Bundesliga
Eintracht Frankfurt,18/19,28950000,33,18900000,28,-10050000,Bundesliga
SV Werder Bremen,18/19,25800000,25,26850000,21,1050000,Bundesliga
Hannover 96,18/19,18520000,24,13540000,22,-4980000,Bundesliga
SC Freiburg,18/19,18400000,21,22680000,22,4280000,Bundesliga
Hertha BSC,18/19,16000000,19,16900000,13,900000,Bundesliga
Bayern Munich,18/19,14000000,7,84000000,10,70000000,Bundesliga
Fortuna D?sseldorf,18/19,7500000,24,600000,23,-6900000,Bundesliga
FC Augsburg,18/19,6650000,22,2850000,13,-3800000,Bundesliga
1.FC Nuremberg,18/19,4850000,11,0,13,-4850000,Bundesliga
Borussia Dortmund,19/20,148500000,22,132250000,18,-16250000,Bundesliga
Bayern Munich,19/20,139500000,11,54000000,11,-85500000,Bundesliga
Hertha BSC,19/20,110700000,20,23450000,18,-87250000,Bundesliga
Bayer 04 Leverkusen,19/20,98200000,12,33500000,10,-64700000,Bundesliga
RB Leipzig,19/20,86500000,16,45250000,15,-41250000,Bundesliga
Eintracht Frankfurt,19/20,78640000,28,114800000,26,36160000,Bundesliga
TSG 1899 Hoffenheim,19/20,55850000,29,121400000,24,65550000,Bundesliga
Borussia M?nchengladbach,19/20,40500000,10,34100000,9,-6400000,Bundesliga
VfL Wolfsburg,19/20,34800000,18,14300000,15,-20500000,Bundesliga
FC Augsburg,19/20,33000000,24,20000000,21,-13000000,Bundesliga
FC Schalke 04,19/20,29500000,23,19450000,21,-10050000,Bundesliga
1.FSV Mainz 05,19/20,28700000,20,27000000,18,-1700000,Bundesliga
1. FC K?ln,19/20,20250000,28,6850000,20,-13400000,Bundesliga
SC Freiburg,19/20,17500000,24,8100000,15,-9400000,Bundesliga
SV Werder Bremen,19/20,13950000,23,0,19,-13950000,Bundesliga
Fortuna D?sseldorf,19/20,11150000,22,11600000,24,450000,Bundesliga
1.FC Union Berlin,19/20,10050000,27,1250000,20,-8800000,Bundesliga
SC Paderborn 07,19/20,750000,26,5800000,25,5050000,Bundesliga
Bayern Munich,20/21,66250000,18,22250000,14,-44000000,Bundesliga
RB Leipzig,20/21,58000000,14,77500000,16,19500000,Bundesliga
Borussia Dortmund,20/21,50000000,17,5500000,10,-44500000,Bundesliga
Bayer 04 Leverkusen,20/21,46200000,15,91000000,8,44800000,Bundesliga
Hertha BSC,20/21,31250000,21,10450000,20,-20800000,Bundesliga
VfL Wolfsburg,20/21,22000000,17,11100000,14,-10900000,Bundesliga
1. FC K?ln,20/21,18500000,31,15000000,24,-3500000,Bundesliga
VfB Stuttgart,20/21,14950000,19,7500000,14,-7450000,Bundesliga
SC Freiburg,20/21,14350000,20,37950000,19,23600000,Bundesliga
Borussia M?nchengladbach,20/21,13500000,18,0,10,-13500000,Bundesliga
SV Werder Bremen,20/21,11000000,26,11700000,23,700000,Bundesliga
Eintracht Frankfurt,20/21,10750000,26,17700000,24,6950000,Bundesliga
FC Augsburg,20/21,10300000,16,8400000,18,-1900000,Bundesliga
TSG 1899 Hoffenheim,20/21,4000000,20,17750000,15,13750000,Bundesliga
FC Schalke 04,20/21,2000000,32,8000000,24,6000000,Bundesliga
1.FSV Mainz 05,20/21,2000000,19,13700000,17,11700000,Bundesliga
1.FC Union Berlin,20/21,1700000,25,6920000,32,5220000,Bundesliga
Arminia Bielefeld,20/21,500000,20,100000,21,-400000,Bundesliga
RB Leipzig,21/22,107620000,31,113500000,20,5880000,Bundesliga
VfL Wolfsburg,21/22,76180000,32,22700000,23,-53480000,Bundesliga
Bayern Munich,21/22,57500000,20,4000000,13,-53500000,Bundesliga
Bayer 04 Leverkusen,21/22,55350000,17,43100000,16,-12250000,Bundesliga
Borussia Dortmund,21/22,45000000,10,109500000,11,64500000,Bundesliga
Hertha BSC,21/22,27400000,28,52500000,19,25100000,Bundesliga
FC Augsburg,21/22,24060000,18,12800000,13,-11260000,Bundesliga
1.FC Union Berlin,21/22,20100000,31,19550000,26,-550000,Bundesliga
Borussia M?nchengladbach,21/22,17000000,16,10200000,15,-6800000,Bundesliga
VfB Stuttgart,21/22,14850000,20,40920000,18,26070000,Bundesliga
Eintracht Frankfurt,21/22,13850000,29,28400000,23,14550000,Bundesliga
Arminia Bielefeld,21/22,10740000,28,500000,27,-10240000,Bundesliga
SC Freiburg,21/22,9500000,16,14550000,12,5050000,Bundesliga
1.FSV Mainz 05,21/22,6900000,22,18050000,22,11150000,Bundesliga
SpVgg Greuther F?rth,21/22,1400000,20,3550000,17,2150000,Bundesliga
1. FC K?ln,21/22,550000,23,23450000,25,22900000,Bundesliga
VfL Bochum,21/22,0,14,350000,12,350000,Bundesliga
TSG 1899 Hoffenheim,21/22,0,20,850000,16,850000,Bundesliga
Bayern Munich,22/23,145500000,22,104100000,17,-41400000,Bundesliga
Borussia Dortmund,22/23,104600000,14,79500000,11,-25100000,Bundesliga
RB Leipzig,22/23,59500000,35,75820000,26,16320000,Bundesliga
VfL Wolfsburg,22/23,35750000,24,23700000,18,-12050000,Bundesliga
Eintracht Frankfurt,22/23,29600000,29,18400000,28,-11200000,Bundesliga
1.FC Union Berlin,22/23,24650000,28,30670000,24,6020000,Bundesliga
Borussia M?nchengladbach,22/23,24000000,17,22000000,13,-2000000,Bundesliga
1.FSV Mainz 05,22/23,23800000,29,24250000,21,450000,Bundesliga
TSG 1899 Hoffenheim,22/23,19800000,25,60200000,22,40400000,Bundesliga
SC Freiburg,22/23,15900000,14,21330000,9,5430000,Bundesliga
Bayer 04 Leverkusen,22/23,15100000,14,9500000,11,-5600000,Bundesliga
VfB Stuttgart,22/23,14790000,25,52600000,24,37810000,Bundesliga
FC Augsburg,22/23,11450000,31,6800000,20,-4650000,Bundesliga
FC Schalke 04,22/23,8630000,43,19750000,38,11120000,Bundesliga
Hertha BSC,22/23,8550000,35,24750000,31,16200000,Bundesliga
1. FC K?ln,22/23,6750000,17,12270000,15,5520000,Bundesliga
SV Werder Bremen,22/23,4000000,21,1850000,17,-2150000,Bundesliga
VfL Bochum,22/23,1790000,23,16050000,25,14260000,Bundesliga
Inter Milan,02/03,116180000,48,103250000,27,-12930000,SerieA
AC Milan,02/03,71100000,38,40600000,28,-30500000,SerieA
AC Parma,02/03,49850000,48,70650000,37,20800000,SerieA
Juventus FC,02/03,40700000,38,14000000,28,-26700000,SerieA
SS Lazio,02/03,11500000,16,80000000,16,68500000,SerieA
AS Roma,02/03,10060000,29,13950000,20,3890000,SerieA
Udinese Calcio,02/03,7000000,31,2700000,29,-4300000,SerieA
Reggina Calcio,02/03,6800000,24,2000000,26,-4800000,SerieA
Brescia Calcio,02/03,5200000,33,2500000,34,-2700000,SerieA
Piacenza FC,02/03,3700000,30,5150000,30,1450000,SerieA
Como Calcio,02/03,2500000,32,500000,35,-2000000,SerieA
Empoli FC,02/03,1150000,24,16070000,21,14920000,SerieA
Chievo Verona,02/03,550000,40,4000000,29,3450000,SerieA
Modena FC,02/03,400000,20,0,19,-400000,SerieA
Torino FC,02/03,250000,35,0,26,-250000,SerieA
Atalanta BC,02/03,0,21,1000000,22,1000000,SerieA
AC Perugia,02/03,0,30,17700000,41,17700000,SerieA
Bologna FC 1909,02/03,0,19,500000,17,500000,SerieA
Inter Milan,03/04,54000000,65,51420000,42,-2580000,SerieA
Juventus FC,03/04,35790000,40,5700000,29,-30090000,SerieA
AS Roma,03/04,26200000,26,0,20,-26200000,SerieA
AC Parma,03/04,24020000,46,79700000,37,55680000,SerieA
SS Lazio,03/04,18030000,25,8850000,21,-9180000,SerieA
AC Milan,03/04,15000000,36,12850000,27,-2150000,SerieA
Chievo Verona,03/04,5450000,49,7550000,52,2100000,SerieA
Reggina Calcio,03/04,4750000,25,0,25,-4750000,SerieA
Modena FC,03/04,3000000,24,0,22,-3000000,SerieA
AC Siena,03/04,2700000,24,0,34,-2700000,SerieA
UC Sampdoria,03/04,2000000,18,0,19,-2000000,SerieA
Ancona Calcio,03/04,115000,43,0,52,-115000,SerieA
Bologna FC 1909,03/04,85000,23,9500000,23,9415000,SerieA
Brescia Calcio,03/04,0,28,14000000,28,14000000,SerieA
Udinese Calcio,03/04,0,29,3400000,26,3400000,SerieA
Empoli FC,03/04,0,19,4990000,17,4990000,SerieA
AC Perugia,03/04,0,47,2500000,41,2500000,SerieA
US Lecce,03/04,0,21,0,23,0,SerieA
Juventus FC,04/05,71120000,42,45450000,29,-25670000,SerieA
ACF Fiorentina,04/05,49500000,23,2000000,26,-47500000,SerieA
AS Roma,04/05,43210000,31,61400000,28,18190000,SerieA
Inter Milan,04/05,15950000,67,29820000,47,13870000,SerieA
US Palermo,04/05,15730000,34,1700000,30,-14030000,SerieA
AC Milan,04/05,11000000,37,12200000,23,1200000,SerieA
SS Lazio,04/05,9500000,27,37500000,22,28000000,SerieA
Atalanta BC,04/05,5400000,26,7880000,25,2480000,SerieA
UC Sampdoria,04/05,3700000,24,500000,24,-3200000,SerieA
Parma FC,04/05,2080000,37,24700000,34,22620000,SerieA
Bologna FC 1909,04/05,1000000,24,680000,21,-320000,SerieA
FC Messina Peloro,04/05,900000,29,0,21,-900000,SerieA
Cagliari Calcio,04/05,700000,14,0,15,-700000,SerieA
AS Livorno,04/05,600000,18,6500000,19,5900000,SerieA
AC Siena,04/05,400000,29,300000,29,-100000,SerieA
US Lecce,04/05,250000,21,27710000,20,27460000,SerieA
Udinese Calcio,04/05,100000,25,2200000,20,2100000,SerieA
Brescia Calcio,04/05,0,25,19750000,21,19750000,SerieA
Chievo Verona,04/05,0,44,8700000,38,8700000,SerieA
Reggina Calcio,04/05,0,28,3300000,29,3300000,SerieA
ACF Fiorentina,05/06,34500000,26,10190000,32,-24310000,SerieA
AC Milan,05/06,33500000,39,12000000,26,-21500000,SerieA
Inter Milan,05/06,30400000,54,22660000,41,-7740000,SerieA
Juventus FC,05/06,30390000,44,14030000,29,-16360000,SerieA
US Palermo,05/06,22350000,32,10000000,28,-12350000,SerieA
Parma FC,05/06,11650000,25,26250000,26,14600000,SerieA
Udinese Calcio,05/06,8650000,52,28000000,34,19350000,SerieA
SS Lazio,05/06,6600000,24,2000000,29,-4600000,SerieA
Cagliari Calcio,05/06,5000000,18,2000000,19,-3000000,SerieA
Reggina Calcio,05/06,3550000,37,14350000,33,10800000,SerieA
Treviso FBC 1993,05/06,2980000,40,5000000,37,2020000,SerieA
AC Siena,05/06,1950000,27,0,31,-1950000,SerieA
AS Roma,05/06,518000,30,6600000,25,6082000,SerieA
UC Sampdoria,05/06,500000,28,0,26,-500000,SerieA
AS Livorno,05/06,300000,25,620000,23,320000,SerieA
Chievo Verona,05/06,250000,37,1200000,29,950000,SerieA
Ascoli Calcio 1898,05/06,200000,39,0,44,-200000,SerieA
Empoli FC,05/06,0,19,0,23,0,SerieA
US Lecce,05/06,0,26,1500000,21,1500000,SerieA
FC Messina Peloro,05/06,0,33,400000,34,400000,SerieA
Inter Milan,06/07,48400000,46,31890000,37,-16510000,SerieA
AC Milan,06/07,41400000,38,57330000,24,15930000,SerieA
US Palermo,06/07,34200000,38,27400000,26,-6800000,SerieA
ACF Fiorentina,06/07,28750000,22,2330000,21,-26420000,SerieA
SS Lazio,06/07,24160000,25,8750000,25,-15410000,SerieA
AS Roma,06/07,21220000,35,19620000,28,-1600000,SerieA
UC Sampdoria,06/07,14340000,38,4170000,33,-10170000,SerieA
Udinese Calcio,06/07,13420000,47,11930000,34,-1490000,SerieA
Torino FC,06/07,9070000,23,900000,23,-8170000,SerieA
Reggina Calcio,06/07,4900000,38,4800000,33,-100000,SerieA
Chievo Verona,06/07,3720000,40,8750000,26,5030000,SerieA
AC Siena,06/07,3450000,32,3000000,31,-450000,SerieA
Atalanta BC,06/07,2720000,25,1900000,24,-820000,SerieA
Empoli FC,06/07,2500000,20,12320000,18,9820000,SerieA
AS Livorno,06/07,2350000,25,720000,28,-1630000,SerieA
Parma FC,06/07,2000000,22,19800000,24,17800000,SerieA
Ascoli Calcio 1898,06/07,1180000,33,2800000,40,1620000,SerieA
FC Messina Peloro,06/07,800000,40,2530000,32,1730000,SerieA
Cagliari Calcio,06/07,700000,16,0,16,-700000,SerieA
Calcio Catania,06/07,60000,25,700000,20,640000,SerieA
Juventus FC,07/08,69450000,52,33630000,40,-35820000,SerieA
AS Roma,07/08,50850000,38,22920000,28,-27930000,SerieA
SSC Napoli,07/08,44060000,27,615000,18,-43445000,SerieA
Inter Milan,07/08,41800000,44,14240000,35,-27560000,SerieA
ACF Fiorentina,07/08,34650000,29,39970000,19,5320000,SerieA
AC Milan,07/08,29000000,40,11110000,22,-17890000,SerieA
US Palermo,07/08,27250000,30,20630000,24,-6620000,SerieA
Udinese Calcio,07/08,21660000,54,30110000,38,8450000,SerieA
Parma FC,07/08,15900000,36,4200000,30,-11700000,SerieA
Genoa CFC,07/08,14730000,34,7810000,35,-6920000,SerieA
UC Sampdoria,07/08,14500000,37,18350000,31,3850000,SerieA
AC Siena,07/08,12850000,38,3380000,33,-9470000,SerieA
Torino FC,07/08,12710000,26,3650000,29,-9060000,SerieA
Cagliari Calcio,07/08,11290000,33,17000000,28,5710000,SerieA
AS Livorno,07/08,11270000,22,11710000,20,440000,SerieA
SS Lazio,07/08,6940000,32,3530000,20,-3410000,SerieA
Reggina Calcio,07/08,6400000,44,18000000,33,11600000,SerieA
Calcio Catania,07/08,6390000,26,5100000,22,-1290000,SerieA
Atalanta BC,07/08,4570000,41,12150000,33,7580000,SerieA
Empoli FC,07/08,1480000,16,11400000,17,9920000,SerieA
AC Milan,08/09,73880000,46,47200000,39,-26680000,SerieA
Inter Milan,08/09,70100000,49,10180000,31,-59920000,SerieA
Genoa CFC,08/09,55910000,60,39400000,44,-16510000,SerieA
US Palermo,08/09,53500000,45,63950000,29,10450000,SerieA
ACF Fiorentina,08/09,49200000,33,18200000,27,-31000000,SerieA
Juventus FC,08/09,40500000,47,31800000,35,-8700000,SerieA
UC Sampdoria,08/09,38350000,60,10800000,40,-27550000,SerieA
AS Roma,08/09,32550000,58,18000000,36,-14550000,SerieA
SSC Napoli,08/09,30800000,24,10650000,20,-20150000,SerieA
SS Lazio,08/09,24550000,40,12700000,27,-11850000,SerieA
Bologna FC 1909,08/09,24400000,22,5100000,19,-19300000,SerieA
Torino FC,08/09,22200000,27,11400000,21,-10800000,SerieA
Udinese Calcio,08/09,20100000,72,35500000,53,15400000,SerieA
Cagliari Calcio,08/09,19010000,20,1150000,22,-17860000,SerieA
AC Siena,08/09,16400000,51,9350000,38,-7050000,SerieA
Atalanta BC,08/09,16050000,44,15200000,33,-850000,SerieA
US Lecce,08/09,9100000,41,2450000,33,-6650000,SerieA
Reggina Calcio,08/09,7350000,46,10180000,35,2830000,SerieA
Calcio Catania,08/09,5500000,33,12300000,25,6800000,SerieA
Chievo Verona,08/09,3900000,42,1500000,33,-2400000,SerieA
Inter Milan,09/10,97200000,61,109100000,44,11900000,SerieA
Genoa CFC,09/10,78990000,88,68950000,56,-10040000,SerieA
Juventus FC,09/10,59300000,51,14300000,31,-45000000,SerieA
SSC Napoli,09/10,55150000,34,4750000,22,-50400000,SerieA
ACF Fiorentina,09/10,38470000,48,45000000,32,6530000,SerieA
SS Lazio,09/10,31200000,43,13200000,26,-18000000,SerieA
Parma FC,09/10,27470000,62,30960000,48,3490000,SerieA
AC Milan,09/10,22100000,41,80660000,26,58560000,SerieA
Calcio Catania,09/10,21500000,46,1150000,32,-20350000,SerieA
AS Bari,09/10,19140000,71,1790000,50,-17350000,SerieA
Udinese Calcio,09/10,18330000,88,36300000,53,17970000,SerieA
AC Siena,09/10,17400000,62,27200000,48,9800000,SerieA
US Palermo,09/10,17300000,53,12790000,38,-4510000,SerieA
Cagliari Calcio,09/10,12750000,22,1050000,16,-11700000,SerieA
Atalanta BC,09/10,11500000,48,22220000,36,10720000,SerieA
Bologna FC 1909,09/10,10470000,29,6200000,32,-4270000,SerieA
UC Sampdoria,09/10,8860000,59,19000000,46,10140000,SerieA
AS Roma,09/10,3500000,45,22080000,36,18580000,SerieA
Chievo Verona,09/10,2300000,55,3900000,44,1600000,SerieA
AS Livorno,09/10,2270000,34,7700000,31,5430000,SerieA
Genoa CFC,10/11,77050000,99,60400000,68,-16650000,SerieA
Juventus FC,10/11,59270000,65,36780000,51,-22490000,SerieA
AC Milan,10/11,51300000,64,25930000,42,-25370000,SerieA
Inter Milan,10/11,38240000,56,66530000,40,28290000,SerieA
US Palermo,10/11,32780000,63,23850000,43,-8930000,SerieA
Parma FC,10/11,31400000,85,18660000,58,-12740000,SerieA
SS Lazio,10/11,29500000,26,27030000,22,-2470000,SerieA
UC Sampdoria,10/11,25890000,53,27000000,40,1110000,SerieA
ACF Fiorentina,10/11,23020000,40,5750000,24,-17270000,SerieA
Bologna FC 1909,10/11,22510000,28,8500000,29,-14010000,SerieA
SSC Napoli,10/11,19800000,47,12900000,27,-6900000,SerieA
Udinese Calcio,10/11,13550000,95,30290000,59,16740000,SerieA
AS Roma,10/11,11200000,38,10650000,31,-550000,SerieA
AS Bari,10/11,10000000,63,15500000,53,5500000,SerieA
Brescia Calcio,10/11,8250000,40,7650000,26,-600000,SerieA
Cagliari Calcio,10/11,6900000,20,8960000,24,2060000,SerieA
Chievo Verona,10/11,6850000,76,101000,58,-6749000,SerieA
AC Cesena,10/11,6570000,62,3600000,61,-2970000,SerieA
US Lecce,10/11,4800000,38,2440000,40,-2360000,SerieA
Calcio Catania,10/11,4200000,30,17000000,30,12800000,SerieA
Juventus FC,11/12,101830000,62,20700000,53,-81130000,SerieA
AS Roma,11/12,91600000,57,26130000,35,-65470000,SerieA
SSC Napoli,11/12,72700000,48,23790000,43,-48910000,SerieA
AC Milan,11/12,65150000,67,22300000,47,-42850000,SerieA
Genoa CFC,11/12,53330000,102,81950000,74,28620000,SerieA
US Palermo,11/12,46030000,69,69650000,49,23620000,SerieA
Inter Milan,11/12,41700000,59,55950000,41,14250000,SerieA
SS Lazio,11/12,22840000,41,26380000,26,3540000,SerieA
Udinese Calcio,11/12,21110000,92,70630000,65,49520000,SerieA
Bologna FC 1909,11/12,20780000,37,21100000,30,320000,SerieA
ACF Fiorentina,11/12,20140000,48,20110000,36,-30000,SerieA
Atalanta BC,11/12,15000000,41,11650000,36,-3350000,SerieA
AC Siena,11/12,14330000,83,2430000,60,-11900000,SerieA
Parma FC,11/12,11910000,110,31000000,80,19090000,SerieA
Chievo Verona,11/12,11450000,84,13090000,61,1640000,SerieA
AC Cesena,11/12,10470000,85,12250000,61,1780000,SerieA
Cagliari Calcio,11/12,8200000,29,25700000,24,17500000,SerieA
Novara Calcio 1908,11/12,5650000,38,2140000,34,-3510000,SerieA
Calcio Catania,11/12,4140000,40,13080000,29,8940000,SerieA
US Lecce,11/12,1400000,40,7570000,37,6170000,SerieA
Inter Milan,12/13,76550000,61,63300000,49,-13250000,SerieA
Juventus FC,12/13,72800000,67,23300000,45,-49500000,SerieA
AC Milan,12/13,59620000,69,88500000,55,28880000,SerieA
AS Roma,12/13,44170000,63,21560000,48,-22610000,SerieA
ACF Fiorentina,12/13,40770000,52,33400000,45,-7370000,SerieA
Udinese Calcio,12/13,31400000,78,60950000,58,29550000,SerieA
SSC Napoli,12/13,31050000,48,34850000,32,3800000,SerieA
Parma FC,12/13,30040000,179,19550000,112,-10490000,SerieA
Genoa CFC,12/13,26930000,104,78250000,78,51320000,SerieA
US Palermo,12/13,26040000,66,24180000,50,-1860000,SerieA
Torino FC,12/13,24980000,35,4380000,38,-20600000,SerieA
UC Sampdoria,12/13,21000000,76,6100000,49,-14900000,SerieA
Atalanta BC,12/13,19350000,49,18450000,36,-900000,SerieA
Delfino Pescara 1936,12/13,17880000,60,13300000,45,-4580000,SerieA
Cagliari Calcio,12/13,11600000,29,2700000,25,-8900000,SerieA
AC Siena,12/13,11420000,89,27250000,76,15830000,SerieA
Chievo Verona,12/13,10300000,77,12630000,58,2330000,SerieA
Bologna FC 1909,12/13,10290000,49,17950000,40,7660000,SerieA
Calcio Catania,12/13,9030000,52,3280000,36,-5750000,SerieA
SS Lazio,12/13,1530000,40,950000,29,-580000,SerieA
SSC Napoli,13/14,107450000,66,74200000,40,-33250000,SerieA
AS Roma,13/14,76290000,64,121390000,52,45100000,SerieA
Inter Milan,13/14,59890000,63,11000000,44,-48890000,SerieA
ACF Fiorentina,13/14,53300000,47,41000000,36,-12300000,SerieA
US Sassuolo,13/14,46500000,48,5000000,36,-41500000,SerieA
Juventus FC,13/14,45500000,66,69090000,46,23590000,SerieA
AC Milan,13/14,43130000,78,17400000,50,-25730000,SerieA
SS Lazio,13/14,26830000,40,28450000,28,1620000,SerieA
Udinese Calcio,13/14,24410000,84,47700000,57,23290000,SerieA
Genoa CFC,13/14,23440000,92,30230000,73,6790000,SerieA
Torino FC,13/14,20250000,39,21840000,32,1590000,SerieA
UC Sampdoria,13/14,19600000,80,25450000,58,5850000,SerieA
Parma FC,13/14,14180000,382,35220000,240,21040000,SerieA
Atalanta BC,13/14,11330000,64,6200000,40,-5130000,SerieA
Calcio Catania,13/14,8370000,53,11090000,45,2720000,SerieA
Hellas Verona,13/14,8100000,71,9500000,55,1400000,SerieA
Bologna FC 1909,13/14,6590000,72,18000000,51,11410000,SerieA
AS Livorno,13/14,4820000,49,1800000,43,-3020000,SerieA
Chievo Verona,13/14,3900000,91,5860000,71,1960000,SerieA
Cagliari Calcio,13/14,1800000,24,7300000,25,5500000,SerieA
AS Roma,14/15,101160000,71,41600000,47,-59560000,SerieA
Juventus FC,14/15,59300000,107,24410000,64,-34890000,SerieA
SSC Napoli,14/15,34800000,56,20450000,40,-14350000,SerieA
Udinese Calcio,14/15,29200000,88,25400000,60,-3800000,SerieA
UC Sampdoria,14/15,24350000,85,27270000,61,2920000,SerieA
Torino FC,14/15,23200000,58,33860000,43,10660000,SerieA
Cagliari Calcio,14/15,22600000,43,21930000,35,-670000,SerieA
Hellas Verona,14/15,22260000,82,30250000,68,7990000,SerieA
US Palermo,14/15,19700000,58,18500000,44,-1200000,SerieA
US Sassuolo,14/15,19300000,38,12600000,35,-6700000,SerieA
Parma FC,14/15,17740000,308,17750000,219,10000,SerieA
Inter Milan,14/15,16950000,88,23600000,57,6650000,SerieA
AC Milan,14/15,16900000,88,28200000,63,11300000,SerieA
SS Lazio,14/15,12750000,49,150000,34,-12600000,SerieA
Atalanta BC,14/15,11090000,89,20000000,57,8910000,SerieA
AC Cesena,14/15,9850000,77,14650000,65,4800000,SerieA
ACF Fiorentina,14/15,9100000,56,38000000,43,28900000,SerieA
Chievo Verona,14/15,8600000,115,5040000,85,-3560000,SerieA
Genoa CFC,14/15,7450000,80,25950000,68,18500000,SerieA
Empoli FC,14/15,860000,47,4560000,41,3700000,SerieA
Juventus FC,15/16,185500000,136,81280000,85,-104220000,SerieA
Inter Milan,15/16,102450000,92,115320000,79,12870000,SerieA
AC Milan,15/16,102280000,66,11160000,57,-91120000,SerieA
AS Roma,15/16,60850000,87,134250000,73,73400000,SerieA
SSC Napoli,15/16,42700000,57,18290000,39,-24410000,SerieA
UC Sampdoria,15/16,34670000,86,16820000,67,-17850000,SerieA
SS Lazio,15/16,31250000,51,2370000,38,-28880000,SerieA
US Sassuolo,15/16,30700000,33,25000000,30,-5700000,SerieA
Torino FC,15/16,28340000,63,19750000,45,-8590000,SerieA
Atalanta BC,15/16,26680000,112,37950000,77,11270000,SerieA
Bologna FC 1909,15/16,26630000,57,800000,50,-25830000,SerieA
ACF Fiorentina,15/16,24900000,69,26850000,59,1950000,SerieA
Udinese Calcio,15/16,21420000,97,74120000,63,52700000,SerieA
Genoa CFC,15/16,16700000,74,43150000,58,26450000,SerieA
US Palermo,15/16,12250000,57,52900000,43,40650000,SerieA
Empoli FC,15/16,6350000,49,11500000,38,5150000,SerieA
Hellas Verona,15/16,6300000,69,2050000,61,-4250000,SerieA
Chievo Verona,15/16,6130000,105,15400000,75,9270000,SerieA
Frosinone Calcio,15/16,400000,26,200000,29,-200000,SerieA
Carpi FC 1909,15/16,300000,47,275000,51,-25000,SerieA
Juventus FC,16/17,170230000,120,176930000,84,6700000,SerieA
Inter Milan,16/17,164710000,97,18500000,57,-146210000,SerieA
AS Roma,16/17,102750000,89,43430000,67,-59320000,SerieA
SSC Napoli,16/17,99090000,59,116810000,40,17720000,SerieA
UC Sampdoria,16/17,39650000,76,80700000,56,41050000,SerieA
SS Lazio,16/17,32850000,44,28700000,36,-4150000,SerieA
Bologna FC 1909,16/17,31300000,51,16980000,46,-14320000,SerieA
AC Milan,16/17,29560000,51,25150000,33,-4410000,SerieA
Torino FC,16/17,28800000,70,26430000,52,-2370000,SerieA
US Sassuolo,16/17,27610000,37,27800000,24,190000,SerieA
Genoa CFC,16/17,27200000,81,50300000,60,23100000,SerieA
Udinese Calcio,16/17,26500000,77,32230000,65,5730000,SerieA
Atalanta BC,16/17,15940000,111,41330000,74,25390000,SerieA
ACF Fiorentina,16/17,15730000,62,31050000,50,15320000,SerieA
Delfino Pescara 1936,16/17,14290000,95,22270000,73,7980000,SerieA
Chievo Verona,16/17,12570000,89,6280000,59,-6290000,SerieA
Cagliari Calcio,16/17,9720000,58,11620000,41,1900000,SerieA
US Palermo,16/17,8480000,53,29250000,40,20770000,SerieA
Empoli FC,16/17,7000000,48,15000000,38,8000000,SerieA
FC Crotone,16/17,5950000,51,7750000,45,1800000,SerieA
AC Milan,17/18,186480000,44,36300000,36,-150180000,SerieA
Juventus FC,17/18,181100000,98,145650000,72,-35450000,SerieA
Inter Milan,17/18,137630000,89,79240000,70,-58390000,SerieA
AS Roma,17/18,91300000,82,155000000,62,63700000,SerieA
ACF Fiorentina,17/18,79500000,61,93580000,50,14080000,SerieA
SSC Napoli,17/18,68500000,48,17450000,33,-51050000,SerieA
Atalanta BC,17/18,63190000,128,81540000,86,18350000,SerieA
UC Sampdoria,17/18,51000000,63,71460000,46,20460000,SerieA
US Sassuolo,17/18,35600000,55,19250000,35,-16350000,SerieA
Cagliari Calcio,17/18,31090000,47,19880000,35,-11210000,SerieA
SS Lazio,17/18,28250000,44,73920000,25,45670000,SerieA
Torino FC,17/18,26380000,66,79800000,42,53420000,SerieA
Benevento Calcio,17/18,23080000,45,3980000,49,-19100000,SerieA
Udinese Calcio,17/18,22590000,55,17700000,38,-4890000,SerieA
Genoa CFC,17/18,14270000,86,46720000,58,32450000,SerieA
Bologna FC 1909,17/18,13000000,54,0,37,-13000000,SerieA
SPAL,17/18,8740000,46,1070000,40,-7670000,SerieA
Hellas Verona,17/18,3050000,54,8050000,43,5000000,SerieA
FC Crotone,17/18,3000000,47,0,46,-3000000,SerieA
Chievo Verona,17/18,2950000,87,17670000,64,14720000,SerieA
Juventus FC,18/19,263200000,54,112540000,36,-150660000,SerieA
AC Milan,18/19,194640000,36,88100000,30,-106540000,SerieA
AS Roma,18/19,166350000,66,150460000,47,-15890000,SerieA
Inter Milan,18/19,97600000,77,91170000,58,-6430000,SerieA
SSC Napoli,18/19,71000000,53,100800000,38,29800000,SerieA
Atalanta BC,18/19,60800000,128,25060000,81,-35740000,SerieA
ACF Fiorentina,18/19,60790000,64,43390000,49,-17400000,SerieA
Genoa CFC,18/19,58970000,103,84360000,81,25390000,SerieA
UC Sampdoria,18/19,56450000,67,90120000,51,33670000,SerieA
Torino FC,18/19,54150000,77,17200000,52,-36950000,SerieA
US Sassuolo,18/19,53970000,70,50380000,44,-3590000,SerieA
Udinese Calcio,18/19,52900000,65,13530000,50,-39370000,SerieA
SS Lazio,18/19,51280000,44,38600000,33,-12680000,SerieA
Bologna FC 1909,18/19,31220000,54,44990000,45,13770000,SerieA
Cagliari Calcio,18/19,22500000,46,7850000,37,-14650000,SerieA
SPAL,18/19,21900000,54,2850000,51,-19050000,SerieA
Parma FC,18/19,20400000,78,596000,55,-19804000,SerieA
Empoli FC,18/19,17300000,68,22900000,51,5600000,SerieA
Frosinone Calcio,18/19,9560000,32,800000,34,-8760000,SerieA
Chievo Verona,18/19,9470000,80,17620000,57,8150000,SerieA
Juventus FC,19/20,231410000,29,203140000,24,-28270000,SerieA
SSC Napoli,19/20,204720000,72,47580000,43,-157140000,SerieA
Inter Milan,19/20,191720000,72,66740000,52,-124980000,SerieA
AC Milan,19/20,124080000,35,59230000,31,-64850000,SerieA
AS Roma,19/20,117400000,54,106380000,46,-11020000,SerieA
Bologna FC 1909,19/20,67040000,57,28680000,43,-38360000,SerieA
US Sassuolo,19/20,66340000,75,51950000,58,-14390000,SerieA
UC Sampdoria,19/20,65250000,62,74590000,51,9340000,SerieA
Atalanta BC,19/20,60360000,123,105100000,79,44740000,SerieA
ACF Fiorentina,19/20,56540000,76,15320000,53,-41220000,SerieA
Genoa CFC,19/20,50370000,100,66350000,86,15980000,SerieA
SS Lazio,19/20,49950000,52,35350000,36,-14600000,SerieA
Cagliari Calcio,19/20,40100000,50,19770000,40,-20330000,SerieA
Torino FC,19/20,28800000,65,24400000,41,-4400000,SerieA
SPAL,19/20,26150000,48,39450000,46,13300000,SerieA
Parma FC,19/20,23310000,95,18160000,83,-5150000,SerieA
Hellas Verona,19/20,21190000,83,43970000,66,22780000,SerieA
Brescia Calcio,19/20,18650000,20,100000,21,-18550000,SerieA
Udinese Calcio,19/20,12600000,53,60270000,42,47670000,SerieA
US Lecce,19/20,6200000,49,450000,45,-5750000,SerieA
Juventus FC,20/21,158010000,26,110560000,21,-47450000,SerieA
Inter Milan,20/21,126500000,59,82550000,41,-43950000,SerieA
Parma FC,20/21,104330000,80,4300000,58,-100030000,SerieA
SSC Napoli,20/21,77250000,55,122060000,40,44810000,SerieA
AS Roma,20/21,72100000,51,48000000,35,-24100000,SerieA
Genoa CFC,20/21,64680000,91,67290000,71,2610000,SerieA
Atalanta BC,20/21,62040000,106,75400000,61,13360000,SerieA
ACF Fiorentina,20/21,57500000,74,59890000,47,2390000,SerieA
Torino FC,20/21,46700000,51,27000000,33,-19700000,SerieA
SS Lazio,20/21,41700000,49,7850000,30,-33850000,SerieA
Cagliari Calcio,20/21,34180000,44,44860000,40,10680000,SerieA
AC Milan,20/21,31920000,40,51390000,31,19470000,SerieA
US Sassuolo,20/21,28500000,68,62360000,43,33860000,SerieA
Udinese Calcio,20/21,21500000,44,31550000,31,10050000,SerieA
Hellas Verona,20/21,18950000,69,5400000,64,-13550000,SerieA
UC Sampdoria,20/21,17750000,56,12100000,42,-5650000,SerieA
Benevento Calcio,20/21,11600000,35,1000000,27,-10600000,SerieA
FC Crotone,20/21,5490000,45,0,41,-5490000,SerieA
Spezia Calcio,20/21,5140000,43,1960000,42,-3180000,SerieA
Bologna FC 1909,20/21,3150000,48,5000000,33,1850000,SerieA
Juventus FC,21/22,129500000,30,63780000,19,-65720000,SerieA
AS Roma,21/22,126550000,55,16190000,42,-110360000,SerieA
AC Milan,21/22,93010000,45,5520000,29,-87490000,SerieA
Atalanta BC,21/22,66000000,124,48840000,71,-17160000,SerieA
ACF Fiorentina,21/22,64400000,62,112200000,46,47800000,SerieA
Inter Milan,21/22,42550000,60,205050000,37,162500000,SerieA
Hellas Verona,21/22,40800000,50,37700000,49,-3100000,SerieA
Genoa CFC,21/22,39100000,109,18620000,74,-20480000,SerieA
US Sassuolo,21/22,37650000,77,22700000,50,-14950000,SerieA
Bologna FC 1909,21/22,32310000,45,25000000,37,-7310000,SerieA
Spezia Calcio,21/22,27790000,47,5200000,49,-22590000,SerieA
SSC Napoli,21/22,22200000,42,3200000,29,-19000000,SerieA
Venezia FC,21/22,22090000,48,200000,42,-21890000,SerieA
Cagliari Calcio,21/22,15100000,45,7400000,34,-7700000,SerieA
UC Sampdoria,21/22,14510000,60,9300000,46,-5210000,SerieA
US Salernitana 1919,21/22,14350000,72,0,65,-14350000,SerieA
SS Lazio,21/22,13800000,54,8900000,37,-4900000,SerieA
Torino FC,21/22,13300000,45,16500000,39,3200000,SerieA
FC Empoli,21/22,10500000,63,28000000,48,17500000,SerieA
Udinese Calcio,21/22,9700000,36,79630000,34,69930000,SerieA
Juventus FC,22/23,106050000,37,110580000,28,4530000,SerieA
Atalanta BC,22/23,99900000,127,105750000,77,5850000,SerieA
SSC Napoli,22/23,76050000,50,80950000,36,4900000,SerieA
US Sassuolo,22/23,53100000,77,75150000,55,22050000,SerieA
Udinese Calcio,22/23,52500000,38,61800000,29,9300000,SerieA
AC Milan,22/23,48670000,38,13050000,31,-35620000,SerieA
US Salernitana 1919,22/23,45330000,56,21500000,62,-23830000,SerieA
AC Monza,22/23,41100000,45,0,45,-41100000,SerieA
Hellas Verona,22/23,39900000,66,34560000,49,-5340000,SerieA
SS Lazio,22/23,39700000,50,36130000,39,-3570000,SerieA
Inter Milan,22/23,38900000,77,7900000,49,-31000000,SerieA
Bologna FC 1909,22/23,37220000,46,45700000,34,8480000,SerieA
ACF Fiorentina,22/23,37150000,56,48250000,37,11100000,SerieA
US Cremonese,22/23,32300000,60,500000,48,-31800000,SerieA
Torino FC,22/23,29330000,46,50600000,41,21270000,SerieA
Spezia Calcio,22/23,18100000,46,37450000,40,19350000,SerieA
FC Empoli,22/23,15200000,75,31920000,64,16720000,SerieA
AS Roma,22/23,9000000,39,67100000,33,58100000,SerieA
US Lecce,22/23,6780000,42,3550000,38,-3230000,SerieA
UC Sampdoria,22/23,6000000,82,34600000,60,28600000,SerieA
Stade Rennais FC,02/03,17830000,23,3500000,19,-14330000,Ligue1
Paris Saint-Germain,02/03,12750000,28,32250000,22,19500000,Ligue1
FC Girondins Bordeaux,02/03,9000000,16,6300000,18,-2700000,Ligue1
Olympique Marseille,02/03,8000000,26,11030000,22,3030000,Ligue1
AS Monaco,02/03,6100000,15,10110000,11,4010000,Ligue1
RC Lens,02/03,5500000,22,18750000,18,13250000,Ligue1
FC Nantes,02/03,5500000,13,2000000,12,-3500000,Ligue1
Olympique Lyon,02/03,3900000,8,700000,7,-3200000,Ligue1
LOSC Lille,02/03,3800000,15,15030000,13,11230000,Ligue1
AJ Auxerre,02/03,1000000,11,0,10,-1000000,Ligue1
OGC Nice,02/03,0,12,4100000,13,4100000,Ligue1
SC Bastia,02/03,0,20,1500000,24,1500000,Ligue1
RC Strasbourg Alsace,02/03,0,19,0,19,0,Ligue1
AC Le Havre,02/03,0,11,0,13,0,Ligue1
FC Sochaux-Montb?liard,02/03,0,13,0,9,0,Ligue1
EA Guingamp,02/03,0,15,0,12,0,Ligue1
Montpellier HSC,02/03,0,8,1400000,10,1400000,Ligue1
CS Sedan-Ardennes,02/03,0,17,7500000,17,7500000,Ligue1
ESTAC Troyes,02/03,0,15,6000000,16,6000000,Ligue1
AC Ajaccio,02/03,0,23,0,17,0,Ligue1
Paris Saint-Germain,03/04,34900000,30,34950000,28,50000,Ligue1
Olympique Lyon,03/04,25500000,11,4150000,10,-21350000,Ligue1
Olympique Marseille,03/04,18850000,31,11500000,27,-7350000,Ligue1
FC Girondins Bordeaux,03/04,11000000,22,16500000,15,5500000,Ligue1
Stade Rennais FC,03/04,5250000,20,6330000,25,1080000,Ligue1
AJ Auxerre,03/04,4400000,10,3530000,10,-870000,Ligue1
AS Monaco,03/04,3200000,19,5250000,20,2050000,Ligue1
EA Guingamp,03/04,1800000,15,10300000,17,8500000,Ligue1
RC Strasbourg Alsace,03/04,1650000,15,4700000,20,3050000,Ligue1
LOSC Lille,03/04,1100000,22,0,14,-1100000,Ligue1
FC Sochaux-Montb?liard,03/04,500000,10,75000,10,-425000,Ligue1
OGC Nice,03/04,480000,13,0,16,-480000,Ligue1
Le Mans Union Club 72,03/04,400000,17,0,8,-400000,Ligue1
SC Bastia,03/04,350000,15,13350000,18,13000000,Ligue1
FC Nantes,03/04,300000,14,4800000,9,4500000,Ligue1
FC Metz,03/04,0,17,3200000,16,3200000,Ligue1
FC Toulouse,03/04,0,12,0,9,0,Ligue1
RC Lens,03/04,0,13,1100000,10,1100000,Ligue1
Montpellier HSC,03/04,0,9,1500000,6,1500000,Ligue1
AC Ajaccio,03/04,0,17,0,17,0,Ligue1
Olympique Marseille,04/05,30280000,33,52380000,31,22100000,Ligue1
Paris Saint-Germain,04/05,27500000,23,17000000,22,-10500000,Ligue1
Olympique Lyon,04/05,26250000,21,22500000,16,-3750000,Ligue1
AS Monaco,04/05,18000000,23,18500000,24,500000,Ligue1
FC Nantes,04/05,8200000,21,21300000,15,13100000,Ligue1
RC Lens,04/05,5500000,22,13000000,21,7500000,Ligue1
FC Sochaux-Montb?liard,04/05,5400000,13,14000000,11,8600000,Ligue1
Stade Rennais FC,04/05,4200000,19,13000000,16,8800000,Ligue1
OGC Nice,04/05,3550000,26,5000000,23,1450000,Ligue1
AJ Auxerre,04/05,3000000,14,27000000,12,24000000,Ligue1
FC Toulouse,04/05,2500000,17,0,15,-2500000,Ligue1
FC Girondins Bordeaux,04/05,1560000,17,8000000,22,6440000,Ligue1
SM Caen,04/05,1530000,9,0,7,-1530000,Ligue1
RC Strasbourg Alsace,04/05,1500000,17,1850000,17,350000,Ligue1
AS Saint-?tienne,04/05,1200000,19,0,24,-1200000,Ligue1
LOSC Lille,04/05,958000,19,10700000,22,9742000,Ligue1
FC Metz,04/05,250000,30,5100000,24,4850000,Ligue1
AC Ajaccio,04/05,195000,17,0,24,-195000,Ligue1
FC Istres Ouest Provence,04/05,80000,24,0,21,-80000,Ligue1
SC Bastia,04/05,0,17,0,17,0,Ligue1
Olympique Lyon,05/06,49600000,21,43400000,15,-6200000,Ligue1
Paris Saint-Germain,05/06,18200000,18,12430000,14,-5770000,Ligue1
Olympique Marseille,05/06,15330000,40,13850000,33,-1480000,Ligue1
Stade Rennais FC,05/06,12800000,16,3700000,12,-9100000,Ligue1
FC Toulouse,05/06,11400000,9,0,12,-11400000,Ligue1
AS Saint-?tienne,05/06,9400000,18,0,15,-9400000,Ligue1
FC Sochaux-Montb?liard,05/06,7500000,22,13700000,19,6200000,Ligue1
RC Lens,05/06,7000000,18,6500000,20,-500000,Ligue1
AS Monaco,05/06,6100000,27,21500000,23,15400000,Ligue1
Le Mans Union Club 72,05/06,6050000,21,3000000,20,-3050000,Ligue1
FC Girondins Bordeaux,05/06,5480000,19,12500000,19,7020000,Ligue1
RC Strasbourg Alsace,05/06,5400000,21,8000000,18,2600000,Ligue1
FC Nantes,05/06,5400000,24,250000,19,-5150000,Ligue1
AJ Auxerre,05/06,5000000,12,17500000,13,12500000,Ligue1
OGC Nice,05/06,4750000,22,250000,19,-4500000,Ligue1
LOSC Lille,05/06,4400000,11,0,9,-4400000,Ligue1
AS Nancy-Lorraine,05/06,3000000,15,0,13,-3000000,Ligue1
FC Metz,05/06,1700000,30,1000000,31,-700000,Ligue1
AC Ajaccio,05/06,500000,19,0,16,-500000,Ligue1
ESTAC Troyes,05/06,250000,18,600000,22,350000,Ligue1
Olympique Lyon,06/07,29950000,17,47330000,12,17380000,Ligue1
AS Monaco,06/07,22600000,29,24550000,23,1950000,Ligue1
Paris Saint-Germain,06/07,16700000,19,4500000,18,-12200000,Ligue1
RC Lens,06/07,16300000,20,18750000,17,2450000,Ligue1
AJ Auxerre,06/07,14500000,14,4500000,17,-10000000,Ligue1
OGC Nice,06/07,13150000,16,5350000,19,-7800000,Ligue1
FC Girondins Bordeaux,06/07,12000000,20,100000,14,-11900000,Ligue1
Stade Rennais FC,06/07,12000000,20,24810000,17,12810000,Ligue1
Olympique Marseille,06/07,11430000,31,9880000,30,-1550000,Ligue1
AS Saint-?tienne,06/07,10710000,21,13350000,21,2640000,Ligue1
AS Nancy-Lorraine,06/07,7800000,13,2800000,6,-5000000,Ligue1
FC Toulouse,06/07,6900000,12,4800000,11,-2100000,Ligue1
FC Nantes,06/07,6800000,26,8000000,27,1200000,Ligue1
LOSC Lille,06/07,6250000,15,4100000,12,-2150000,Ligue1
Le Mans Union Club 72,06/07,5500000,12,7000000,15,1500000,Ligue1
FC Sochaux-Montb?liard,06/07,5300000,21,17100000,24,11800000,Ligue1
ESTAC Troyes,06/07,3900000,17,1600000,20,-2300000,Ligue1
Valenciennes FC,06/07,3700000,10,0,13,-3700000,Ligue1
FC Lorient,06/07,1350000,21,2000000,26,650000,Ligue1
CS Sedan-Ardennes,06/07,150000,16,0,16,-150000,Ligue1
Olympique Lyon,07/08,56900000,18,63500000,18,6600000,Ligue1
Olympique Marseille,07/08,30000000,37,38900000,28,8900000,Ligue1
RC Lens,07/08,23700000,25,19050000,20,-4650000,Ligue1
FC Girondins Bordeaux,07/08,20800000,20,19000000,17,-1800000,Ligue1
Paris Saint-Germain,07/08,20500000,26,14300000,20,-6200000,Ligue1
AS Monaco,07/08,20400000,26,21800000,23,1400000,Ligue1
AS Saint-?tienne,07/08,20300000,23,18850000,19,-1450000,Ligue1
AJ Auxerre,07/08,13900000,17,36700000,18,22800000,Ligue1
Stade Rennais FC,07/08,11550000,20,24200000,19,12650000,Ligue1
FC Toulouse,07/08,8200000,22,2400000,15,-5800000,Ligue1
Le Mans Union Club 72,07/08,7500000,16,14250000,13,6750000,Ligue1
FC Sochaux-Montb?liard,07/08,7000000,21,11300000,22,4300000,Ligue1
LOSC Lille,07/08,6800000,23,40350000,17,33550000,Ligue1
Valenciennes FC,07/08,4500000,9,1100000,11,-3400000,Ligue1
SM Caen,07/08,3100000,14,400000,7,-2700000,Ligue1
FC Lorient,07/08,2850000,17,4500000,20,1650000,Ligue1
OGC Nice,07/08,2200000,21,9800000,17,7600000,Ligue1
RC Strasbourg Alsace,07/08,1350000,31,1350000,24,0,Ligue1
FC Metz,07/08,600000,23,7500000,20,6900000,Ligue1
AS Nancy-Lorraine,07/08,0,10,4650000,10,4650000,Ligue1
Olympique Lyon,08/09,50300000,18,34000000,15,-16300000,Ligue1
Olympique Marseille,08/09,36120000,34,23650000,28,-12470000,Ligue1
OGC Nice,08/09,20250000,17,35900000,14,15650000,Ligue1
LOSC Lille,08/09,18500000,19,20300000,18,1800000,Ligue1
Le Mans Union Club 72,08/09,14300000,15,22600000,17,8300000,Ligue1
Stade Rennais FC,08/09,14000000,24,11950000,15,-2050000,Ligue1
Paris Saint-Germain,08/09,10500000,22,21750000,17,11250000,Ligue1
AS Nancy-Lorraine,08/09,10500000,18,15400000,16,4900000,Ligue1
FC Toulouse,08/09,9800000,21,22700000,20,12900000,Ligue1
AS Saint-?tienne,08/09,9500000,22,11000000,14,1500000,Ligue1
FC Nantes,08/09,8600000,24,6600000,21,-2000000,Ligue1
AJ Auxerre,08/09,8400000,17,3400000,12,-5000000,Ligue1
FC Girondins Bordeaux,08/09,7900000,17,2500000,16,-5400000,Ligue1
Valenciennes FC,08/09,7800000,14,10200000,14,2400000,Ligue1
SM Caen,08/09,7640000,16,7820000,12,180000,Ligue1
FC Sochaux-Montb?liard,08/09,6550000,26,5800000,19,-750000,Ligue1
AS Monaco,08/09,5200000,34,22650000,21,17450000,Ligue1
FC Lorient,08/09,3000000,19,0,18,-3000000,Ligue1
Grenoble Foot 38,08/09,1480000,17,350000,13,-1130000,Ligue1
AC Le Havre,08/09,400000,24,3000000,22,2600000,Ligue1
Olympique Lyon,09/10,82700000,17,53000000,11,-29700000,Ligue1
Olympique Marseille,09/10,42300000,32,27800000,23,-14500000,Ligue1
FC Girondins Bordeaux,09/10,28500000,23,11000000,13,-17500000,Ligue1
AS Saint-?tienne,09/10,19500000,15,14400000,15,-5100000,Ligue1
Paris Saint-Germain,09/10,15500000,18,6300000,17,-9200000,Ligue1
Stade Rennais FC,09/10,14600000,25,13800000,21,-800000,Ligue1
AS Monaco,09/10,9900000,24,6080000,22,-3820000,Ligue1
LOSC Lille,09/10,8600000,18,18750000,18,10150000,Ligue1
FC Sochaux-Montb?liard,09/10,7500000,21,10200000,18,2700000,Ligue1
FC Lorient,09/10,7000000,19,9500000,19,2500000,Ligue1
FC Toulouse,09/10,6000000,14,11950000,12,5950000,Ligue1
AS Nancy-Lorraine,09/10,5700000,22,5600000,15,-100000,Ligue1
Valenciennes FC,09/10,5450000,15,500000,11,-4950000,Ligue1
RC Lens,09/10,4950000,20,3000000,14,-1950000,Ligue1
Grenoble Foot 38,09/10,3600000,13,0,17,-3600000,Ligue1
OGC Nice,09/10,3500000,14,1450000,11,-2050000,Ligue1
Le Mans Union Club 72,09/10,2630000,23,10500000,14,7870000,Ligue1
US Boulogne,09/10,2040000,20,2150000,16,110000,Ligue1
AJ Auxerre,09/10,1500000,19,4700000,15,3200000,Ligue1
Montpellier HSC,09/10,0,11,0,9,0,Ligue1
Olympique Marseille,10/11,41500000,20,22600000,17,-18900000,Ligue1
Olympique Lyon,10/11,28440000,10,10820000,12,-17620000,Ligue1
Stade Rennais FC,10/11,22200000,23,34130000,17,11930000,Ligue1
FC Girondins Bordeaux,10/11,10500000,24,22000000,16,11500000,Ligue1
AS Monaco,10/11,9750000,37,14100000,31,4350000,Ligue1
Paris Saint-Germain,10/11,9000000,14,7000000,11,-2000000,Ligue1
FC Lorient,10/11,6000000,20,12800000,16,6800000,Ligue1
Montpellier HSC,10/11,4300000,16,14000000,13,9700000,Ligue1
SM Caen,10/11,4200000,11,0,10,-4200000,Ligue1
AS Saint-?tienne,10/11,3930000,19,5250000,16,1320000,Ligue1
Stade Brestois 29,10/11,3800000,14,0,15,-3800000,Ligue1
AJ Auxerre,10/11,3500000,13,2430000,11,-1070000,Ligue1
FC Sochaux-Montb?liard,10/11,3300000,14,2500000,10,-800000,Ligue1
Valenciennes FC,10/11,1800000,11,8500000,12,6700000,Ligue1
OGC Nice,10/11,1700000,16,23000000,17,21300000,Ligue1
FC Toulouse,10/11,0,11,16650000,15,16650000,Ligue1
RC Lens,10/11,0,16,8320000,11,8320000,Ligue1
LOSC Lille,10/11,0,12,2300000,9,2300000,Ligue1
AS Nancy-Lorraine,10/11,0,17,8050000,17,8050000,Ligue1
Athl?tic Club Arl?sien,10/11,0,27,500000,34,500000,Ligue1
Paris Saint-Germain,11/12,107100000,22,9400000,14,-97700000,Ligue1
LOSC Lille,11/12,23400000,23,36900000,20,13500000,Ligue1
Stade Rennais FC,11/12,16800000,13,5500000,13,-11300000,Ligue1
AS Saint-?tienne,11/12,16100000,28,28860000,23,12760000,Ligue1
FC Toulouse,11/12,13340000,11,4800000,12,-8540000,Ligue1
FC Lorient,11/12,11100000,24,16000000,23,4900000,Ligue1
Olympique Marseille,11/12,11000000,18,0,17,-11000000,Ligue1
OGC Nice,11/12,8350000,20,600000,19,-7750000,Ligue1
Dijon FCO,11/12,5850000,26,0,19,-5850000,Ligue1
AS Nancy-Lorraine,11/12,5350000,23,9600000,25,4250000,Ligue1
FC Sochaux-Montb?liard,11/12,5250000,14,11500000,14,6250000,Ligue1
Olympique Lyon,11/12,4600000,16,22000000,10,17400000,Ligue1
Valenciennes FC,11/12,4100000,9,4200000,9,100000,Ligue1
FC Girondins Bordeaux,11/12,4000000,19,12500000,15,8500000,Ligue1
AJ Auxerre,11/12,3750000,26,3500000,16,-250000,Ligue1
Stade Brestois 29,11/12,2500000,16,8000000,12,5500000,Ligue1
Montpellier HSC,11/12,2000000,14,2000000,12,0,Ligue1
FC ?vian Thonon Gaillard,11/12,1850000,17,0,15,-1850000,Ligue1
SM Caen,11/12,300000,14,9000000,13,8700000,Ligue1
AC Ajaccio,11/12,200000,14,0,9,-200000,Ligue1
Paris Saint-Germain,12/13,151000000,19,4750000,15,-146250000,Ligue1
LOSC Lille,12/13,22500000,21,41200000,17,18700000,Ligue1
Montpellier HSC,12/13,12500000,13,20000000,6,7500000,Ligue1
FC Lorient,12/13,10000000,17,5000000,15,-5000000,Ligue1
Olympique Lyon,12/13,8750000,18,30100000,20,21350000,Ligue1
Olympique Marseille,12/13,8700000,18,29800000,16,21100000,Ligue1
Stade Rennais FC,12/13,8700000,20,27500000,17,18800000,Ligue1
FC Sochaux-Montb?liard,12/13,7750000,15,16860000,11,9110000,Ligue1
OGC Nice,12/13,6000000,21,8700000,17,2700000,Ligue1
AS Nancy-Lorraine,12/13,4700000,29,6500000,24,1800000,Ligue1
AS Saint-?tienne,12/13,4500000,22,4600000,19,100000,Ligue1
Stade Reims,12/13,3350000,13,0,19,-3350000,Ligue1
Valenciennes FC,12/13,3100000,11,4000000,10,900000,Ligue1
FC Girondins Bordeaux,12/13,2800000,12,5500000,8,2700000,Ligue1
Stade Brestois 29,12/13,2450000,14,1500000,17,-950000,Ligue1
FC ?vian Thonon Gaillard,12/13,1600000,9,0,13,-1600000,Ligue1
FC Toulouse,12/13,1000000,13,14100000,14,13100000,Ligue1
ESTAC Troyes,12/13,500000,20,4450000,18,3950000,Ligue1
SC Bastia,12/13,0,18,7500000,16,7500000,Ligue1
AC Ajaccio,12/13,0,14,1000000,13,1000000,Ligue1
AS Monaco,13/14,160700000,40,5550000,32,-155150000,Ligue1
Paris Saint-Germain,13/14,135900000,22,26500000,17,-109400000,Ligue1
Olympique Marseille,13/14,39400000,21,1050000,15,-38350000,Ligue1
AS Saint-?tienne,13/14,16600000,22,42950000,21,26350000,Ligue1
Stade Rennais FC,13/14,15050000,27,16600000,25,1550000,Ligue1
FC Toulouse,13/14,13550000,16,20700000,12,7150000,Ligue1
Olympique Lyon,13/14,4000000,16,24500000,9,20500000,Ligue1
FC Girondins Bordeaux,13/14,3500000,14,11000000,11,7500000,Ligue1
FC Nantes,13/14,3350000,12,500000,12,-2850000,Ligue1
FC Sochaux-Montb?liard,13/14,3150000,20,2500000,19,-650000,Ligue1
Stade Reims,13/14,3130000,15,0,9,-3130000,Ligue1
FC Lorient,13/14,3000000,19,12090000,16,9090000,Ligue1
LOSC Lille,13/14,2950000,19,42000000,13,39050000,Ligue1
FC ?vian Thonon Gaillard,13/14,2600000,18,8500000,22,5900000,Ligue1
Montpellier HSC,13/14,2500000,13,14500000,16,12000000,Ligue1
SC Bastia,13/14,1800000,19,2200000,25,400000,Ligue1
EA Guingamp,13/14,1200000,11,7500000,12,6300000,Ligue1
Valenciennes FC,13/14,1200000,13,6000000,16,4800000,Ligue1
OGC Nice,13/14,0,14,0,10,0,Ligue1
AC Ajaccio,13/14,0,19,0,25,0,Ligue1
Paris Saint-Germain,14/15,49500000,11,2200000,9,-47300000,Ligue1
AS Monaco,14/15,39750000,35,89120000,32,49370000,Ligue1
Olympique Marseille,14/15,20500000,20,17500000,17,-3000000,Ligue1
Stade Rennais FC,14/15,15140000,30,20500000,21,5360000,Ligue1
FC Lorient,14/15,8450000,21,19200000,22,10750000,Ligue1
LOSC Lille,14/15,7800000,16,19730000,13,11930000,Ligue1
FC Girondins Bordeaux,14/15,7700000,22,4500000,15,-3200000,Ligue1
Olympique Lyon,14/15,5650000,8,1500000,9,-4150000,Ligue1
AS Saint-?tienne,14/15,4000000,10,0,13,-4000000,Ligue1
Montpellier HSC,14/15,4000000,15,15900000,14,11900000,Ligue1
FC Metz,14/15,3600000,26,7650000,20,4050000,Ligue1
FC Toulouse,14/15,3000000,12,13700000,9,10700000,Ligue1
EA Guingamp,14/15,2560000,13,2500000,14,-60000,Ligue1
FC ?vian Thonon Gaillard,14/15,2250000,20,3000000,23,750000,Ligue1
OGC Nice,14/15,1300000,14,7400000,16,6100000,Ligue1
SM Caen,14/15,800000,16,0,15,-800000,Ligue1
FC Nantes,14/15,420000,12,0,11,-420000,Ligue1
SC Bastia,14/15,100000,29,2000000,25,1900000,Ligue1
RC Lens,14/15,0,7,3000000,11,3000000,Ligue1
Stade Reims,14/15,0,12,5500000,13,5500000,Ligue1
Paris Saint-Germain,15/16,116100000,13,22900000,11,-93200000,Ligue1
AS Monaco,15/16,101060000,42,175400000,33,74340000,Ligue1
Olympique Lyon,15/16,41100000,13,26800000,13,-14300000,Ligue1
AS Saint-?tienne,15/16,20300000,21,23200000,16,2900000,Ligue1
Olympique Marseille,15/16,19750000,30,54450000,25,34700000,Ligue1
LOSC Lille,15/16,12900000,31,35250000,20,22350000,Ligue1
FC Girondins Bordeaux,15/16,11000000,15,22300000,15,11300000,Ligue1
FC Lorient,15/16,9930000,18,18500000,17,8570000,Ligue1
FC Nantes,15/16,7000000,15,17550000,17,10550000,Ligue1
SM Caen,15/16,6050000,23,14000000,18,7950000,Ligue1
Stade Rennais FC,15/16,5640000,28,10600000,20,4960000,Ligue1
OGC Nice,15/16,4100000,28,14000000,23,9900000,Ligue1
FC Toulouse,15/16,2900000,13,10500000,14,7600000,Ligue1
Montpellier HSC,15/16,2730000,13,4000000,10,1270000,Ligue1
Stade Reims,15/16,2400000,14,1500000,13,-900000,Ligue1
EA Guingamp,15/16,1950000,19,6000000,15,4050000,Ligue1
ESTAC Troyes,15/16,300000,19,7300000,23,7000000,Ligue1
SC Bastia,15/16,0,15,1700000,18,1700000,Ligue1
Angers SCO,15/16,0,29,5900000,23,5900000,Ligue1
GFC Ajaccio,15/16,0,9,0,12,0,Ligue1
Paris Saint-Germain,16/17,134500000,21,59800000,15,-74700000,Ligue1
Olympique Marseille,16/17,53000000,31,81490000,31,28490000,Ligue1
AS Monaco,16/17,50500000,35,18450000,29,-32050000,Ligue1
Olympique Lyon,16/17,28600000,17,27300000,13,-1300000,Ligue1
LOSC Lille,16/17,20700000,27,47000000,31,26300000,Ligue1
OGC Nice,16/17,15250000,25,15800000,22,550000,Ligue1
FC Toulouse,16/17,13000000,23,10000000,18,-3000000,Ligue1
FC Girondins Bordeaux,16/17,11850000,18,2600000,17,-9250000,Ligue1
FC Lorient,16/17,8600000,31,32150000,20,23550000,Ligue1
AS Saint-?tienne,16/17,7000000,18,2250000,18,-4750000,Ligue1
Montpellier HSC,16/17,6400000,15,19400000,18,13000000,Ligue1
Angers SCO,16/17,5200000,25,4400000,22,-800000,Ligue1
FC Nantes,16/17,5000000,14,2650000,14,-2350000,Ligue1
SM Caen,16/17,4250000,14,11000000,12,6750000,Ligue1
Dijon FCO,16/17,3150000,18,1250000,16,-1900000,Ligue1
AS Nancy-Lorraine,16/17,2300000,14,10900000,11,8600000,Ligue1
Stade Rennais FC,16/17,2270000,28,55300000,22,53030000,Ligue1
FC Metz,16/17,400000,31,775000,30,375000,Ligue1
SC Bastia,16/17,250000,22,7000000,25,6750000,Ligue1
EA Guingamp,16/17,0,18,7000000,18,7000000,Ligue1
Paris Saint-Germain,17/18,238000000,18,98400000,15,-139600000,Ligue1
AS Monaco,17/18,122400000,35,199500000,23,77100000,Ligue1
LOSC Lille,17/18,76500000,36,31100000,31,-45400000,Ligue1
Olympique Marseille,17/18,62000000,21,2750000,22,-59250000,Ligue1
Olympique Lyon,17/18,58050000,28,119550000,22,61500000,Ligue1
Stade Rennais FC,17/18,53900000,26,15800000,23,-38100000,Ligue1
FC Girondins Bordeaux,17/18,32600000,30,28250000,25,-4350000,Ligue1
OGC Nice,17/18,26300000,20,27500000,21,1200000,Ligue1
AS Saint-?tienne,17/18,19300000,24,15500000,25,-3800000,Ligue1
Angers SCO,17/18,12400000,24,26000000,23,13600000,Ligue1
FC Nantes,17/18,11300000,17,10000000,13,-1300000,Ligue1
SM Caen,17/18,6950000,23,6000000,18,-950000,Ligue1
Amiens SC,17/18,6630000,24,8000000,20,1370000,Ligue1
Montpellier HSC,17/18,5700000,15,20800000,19,15100000,Ligue1
Dijon FCO,17/18,5500000,16,15000000,16,9500000,Ligue1
RC Strasbourg Alsace,17/18,5400000,16,2000000,18,-3400000,Ligue1
FC Metz,17/18,3600000,28,22850000,26,19250000,Ligue1
FC Toulouse,17/18,3500000,12,13000000,18,9500000,Ligue1
EA Guingamp,17/18,1380000,19,5950000,16,4570000,Ligue1
ESTAC Troyes,17/18,0,11,0,14,0,Ligue1
Paris Saint-Germain,18/19,262000000,26,114000000,18,-148000000,Ligue1
AS Monaco,18/19,145850000,51,367250000,33,221400000,Ligue1
Olympique Marseille,18/19,66000000,16,32850000,11,-33150000,Ligue1
Olympique Lyon,18/19,46450000,22,90100000,17,43650000,Ligue1
OGC Nice,18/19,28000000,15,61700000,12,33700000,Ligue1
FC Girondins Bordeaux,18/19,21460000,25,50700000,23,29240000,Ligue1
FC Toulouse,18/19,18450000,26,35500000,20,17050000,Ligue1
Stade Rennais FC,18/19,18000000,24,18500000,17,500000,Ligue1
RC Strasbourg Alsace,18/19,15750000,17,14000000,15,-1750000,Ligue1
Stade Reims,18/19,15500000,21,11000000,17,-4500000,Ligue1
AS Saint-?tienne,18/19,15000000,28,18700000,24,3700000,Ligue1
FC Nantes,18/19,14350000,19,11200000,23,-3150000,Ligue1
Montpellier HSC,18/19,10150000,16,25500000,11,15350000,Ligue1
SM Caen,18/19,9950000,30,14500000,30,4550000,Ligue1
Dijon FCO,18/19,9200000,16,4000000,15,-5200000,Ligue1
LOSC Lille,18/19,8900000,19,69700000,22,60800000,Ligue1
Amiens SC,18/19,7490000,27,10000000,32,2510000,Ligue1
Angers SCO,18/19,4450000,26,21000000,21,16550000,Ligue1
EA Guingamp,18/19,3500000,18,4000000,14,500000,Ligue1
N?mes Olympique,18/19,3150000,14,0,11,-3150000,Ligue1
AS Monaco,19/20,200000000,53,83750000,42,-116250000,Ligue1
Olympique Lyon,19/20,126000000,19,160320000,16,34320000,Ligue1
LOSC Lille,19/20,99400000,24,151000000,18,51600000,Ligue1
Paris Saint-Germain,19/20,95000000,24,105900000,19,10900000,Ligue1
Stade Rennais FC,19/20,58100000,27,54500000,23,-3600000,Ligue1
OGC Nice,19/20,52200000,20,23110000,19,-29090000,Ligue1
Olympique Marseille,19/20,27000000,12,27250000,13,250000,Ligue1
Montpellier HSC,19/20,20300000,18,40000000,17,19700000,Ligue1
FC Nantes,19/20,18750000,27,38500000,22,19750000,Ligue1
Stade Reims,19/20,18700000,20,26600000,21,7900000,Ligue1
Amiens SC,19/20,18150000,30,5440000,25,-12710000,Ligue1
FC Girondins Bordeaux,19/20,17000000,22,62250000,20,45250000,Ligue1
FC Metz,19/20,14350000,27,2600000,20,-11750000,Ligue1
FC Toulouse,19/20,14000000,26,17150000,22,3150000,Ligue1
AS Saint-?tienne,19/20,13450000,34,45850000,20,32400000,Ligue1
RC Strasbourg Alsace,19/20,11000000,11,21500000,14,10500000,Ligue1
Dijon FCO,19/20,10470000,17,24500000,19,14030000,Ligue1
Angers SCO,19/20,10400000,23,34000000,19,23600000,Ligue1
N?mes Olympique,19/20,9850000,18,20500000,19,10650000,Ligue1
Stade Brestois 29,19/20,7500000,15,500000,15,-7000000,Ligue1
Stade Rennais FC,20/21,70560000,24,55420000,24,-15140000,Ligue1
Paris Saint-Germain,20/21,62000000,21,400000,19,-61600000,Ligue1
AS Monaco,20/21,52700000,48,13530000,33,-39170000,Ligue1
LOSC Lille,20/21,40430000,25,104180000,14,63750000,Ligue1
Olympique Lyon,20/21,36690000,21,50600000,22,13910000,Ligue1
OGC Nice,20/21,29230000,35,20510000,29,-8720000,Ligue1
FC Lorient,20/21,26500000,26,6500000,22,-20000000,Ligue1
RC Lens,20/21,19000000,19,0,19,-19000000,Ligue1
Olympique Marseille,20/21,17420000,16,32050000,16,14630000,Ligue1
Stade Brestois 29,20/21,16100000,19,12000000,18,-4100000,Ligue1
Dijon FCO,20/21,15800000,22,17000000,21,1200000,Ligue1
FC Metz,20/21,14700000,26,10000000,22,-4700000,Ligue1
Montpellier HSC,20/21,13100000,12,0,8,-13100000,Ligue1
RC Strasbourg Alsace,20/21,12000000,10,500000,9,-11500000,Ligue1
N?mes Olympique,20/21,11250000,14,2500000,8,-8750000,Ligue1
Angers SCO,20/21,11250000,21,10700000,16,-550000,Ligue1
Stade Reims,20/21,11200000,14,17000000,14,5800000,Ligue1
AS Saint-?tienne,20/21,5600000,29,44100000,26,38500000,Ligue1
FC Nantes,20/21,5000000,16,2000000,14,-3000000,Ligue1
FC Girondins Bordeaux,20/21,0,20,17000000,14,17000000,Ligue1
Paris Saint-Germain,21/22,91000000,34,11000000,19,-80000000,Ligue1
Stade Rennais FC,21/22,81500000,28,45650000,20,-35850000,Ligue1
OGC Nice,21/22,55000000,29,26050000,26,-28950000,Ligue1
Olympique Marseille,21/22,54120000,27,7500000,27,-46620000,Ligue1
AS Monaco,21/22,45500000,29,34640000,24,-10860000,Ligue1
LOSC Lille,21/22,25600000,19,76160000,17,50560000,Ligue1
Olympique Lyon,21/22,22920000,26,95600000,18,72680000,Ligue1
ESTAC Troyes,21/22,21800000,29,0,27,-21800000,Ligue1
RC Lens,21/22,20600000,24,18000000,19,-2600000,Ligue1
Stade Reims,21/22,16000000,30,15050000,17,-950000,Ligue1
FC Lorient,21/22,10500000,20,10000000,17,-500000,Ligue1
FC Girondins Bordeaux,21/22,9800000,27,18600000,28,8800000,Ligue1
Stade Brestois 29,21/22,9500000,15,28200000,18,18700000,Ligue1
FC Nantes,21/22,7500000,14,15800000,18,8300000,Ligue1
RC Strasbourg Alsace,21/22,4500000,22,16000000,22,11500000,Ligue1
FC Metz,21/22,2500000,32,21500000,23,19000000,Ligue1
Angers SCO,21/22,1870000,16,18100000,15,16230000,Ligue1
AS Saint-?tienne,21/22,600000,16,0,19,-600000,Ligue1
Montpellier HSC,21/22,200000,13,25000000,16,24800000,Ligue1
Clermont Foot 63,21/22,0,24,0,18,0,Ligue1
Paris Saint-Germain,22/23,147500000,41,59300000,35,-88200000,Ligue1
Olympique Marseille,22/23,115400000,34,37480000,34,-77920000,Ligue1
OGC Nice,22/23,84000000,34,44400000,30,-39600000,Ligue1
Stade Rennais FC,22/23,80500000,30,95000000,23,14500000,Ligue1
AS Monaco,22/23,43500000,26,157000000,24,113500000,Ligue1
RC Lens,22/23,38350000,24,51590000,18,13240000,Ligue1
Olympique Lyon,22/23,32450000,28,78850000,23,46400000,Ligue1
FC Lorient,22/23,30200000,37,39350000,30,9150000,Ligue1
LOSC Lille,22/23,26000000,18,101500000,17,75500000,Ligue1
ESTAC Troyes,22/23,24800000,31,10000000,31,-14800000,Ligue1
Stade Reims,22/23,16100000,37,28800000,32,12700000,Ligue1
FC Toulouse,22/23,14000000,22,11000000,16,-3000000,Ligue1
FC Nantes,22/23,12450000,20,0,17,-12450000,Ligue1
Montpellier HSC,22/23,9500000,17,10000000,16,500000,Ligue1
RC Strasbourg Alsace,22/23,7000000,23,10900000,18,3900000,Ligue1
Angers SCO,22/23,6000000,26,37000000,20,31000000,Ligue1
Stade Brestois 29,22/23,5350000,22,2100000,24,-3250000,Ligue1
Clermont Foot 63,22/23,2300000,30,21400000,27,19100000,Ligue1
AJ Auxerre,22/23,1750000,31,500000,24,-1250000,Ligue1
AC Ajaccio,22/23,300000,16,600000,14,300000,Ligue1
